irumeng	iru(N)^[Abl_Mod.Sg]
kalereqiteki	kalereqe(V)^[Opt.Pres.Trns]^[2Pl.3Pl]
yuvghiiq	yuvghiigh(V)^[Abs.Sg]
nakut	nakut(WH)
tawatelkutat	tawate(V)^–lgute(V→V)^[Abs.Pl]
tawatelkutat	tawate(V)^–lgute(V→V)^[Abs.Pl]
kalereqiteggu	kalereqe(V)^[Opt.Pres.Trns]^[2Pl.3Sg]
aatkalghii	aatkagh(N)^[Ptcp.Intr]^[3Sg]
Salimeng	Sali(N)^[Abl_Mod.Sg]
pitngunghillnguq	pitngu(V)^@–nghite(V→V)^[Ptcp.Intr]^[3Sg]
pitngunghillnguq	pitngu(V)^@–nghite(V→V)^[Ptcp.Intr]^[3Sg]
pitngunghilnguq	pitngu(V)^@–nghite(V→V)^[Ptcp.Intr]^[3Sg]
esqhaghteki	esghagh(V)^[Opt.Pres.Trns]^[2Pl.3Pl]
qafsinwaat	qafsineg(WH)^~:(ng)u(N→V)^[Ind.Trns]^[3Pl.3Sg]
yalumeng	yalu(N)^[Abl_Mod.Sg]
natu	natu(WH)
piitesaghaq	piitesighagh(N)^[Abs.Sg]
piitesiighaq	piitesighagh(N)^[Abs.Sg]
ighal	ighaleqetaagh(N)^[Abl_Mod.Sg]
eqetaaghmeng	ighaleqetaagh(N)^[Abl_Mod.Sg]
piitesiighaghmeng	piitesighagh(N)^[Abl_Mod.Sg]
tawatekullghiik	tawate(V)^~–ke(N→V)^[Ptcp.Intr]^[3Du]
tawatekullghiik	tawate(V)^~–ke(N→V)^[Ptcp.Intr]^[3Du]
Mirim	Miri(N)^[Rel.Sg]
Jimim	Jimi(N)^[Rel.Sg]
qerngughhnemki	qerngughte(V)^[Ctmp.Trns]^[1Sg.3Pl]
kumegaasiq	kumegagh(V)^~:(u)sigh(V→N)^[Abs.Sg]
ullqhitaghaquq	ullghitagh(V)^~(g)aqe(V→V)^[Ind.Intr]^[3Sg]
upenghaam	upenghagh(N)^[Rel.Sg]
kalernga	kalere(N)^[Abs.3SgPoss.Sg]
pingayuneng-inglulek	pingayuneng ingluleg(NUM)
estamaneng-inglulek	estamaneng ingluleg(NUM)
lleghlleq	?^–llegh(V→N)^[Abs.Sg]
nine	nine(NUM)
lleghlleghmeta	?^–llegh(V→N)^~fmete(N→V)^[Abs.Sg]
maligsaaghleki	maligsaagh(V)^[Opt.Pres.Trns]^[1Pl.3Pl]
allaaghhiinagut	allaghhiinagh(PTCL)^[Ind.Intr]^[3Pl]
allaaghhiinagut	allaghhiinagh(PTCL)^[Ind.Intr]^[3Pl]
allaaghhiinagut	allaghhiinagh(PTCL)^[Ind.Intr]^[3Pl]
kalerngit	kalere(N)^[Abs.3PlPoss.Pl]
kalereqnaakesi	kalereqe(V)^[Opt.Fut.Trns]^[2Pl.3Pl]
kalereqnaakesi	kalereqe(V)^[Opt.Fut.Trns]^[2Pl.3Pl]
X	X
unaghsighwaat	unaghsigh(N)^––igh(N→V)^[Ind.Trns]^[3Pl.3Sg]
tagitugughusimakangi	tagitug(N)^?^@~:(i/u)ma(V→V)^[Ptcp.Trns]^[3Sg.3Pl]
tespaganlluki	[Anaphor]^paagna(DEM.PRO.Abs.Sg)^[Sbrd.Trns]^[_.3Pl]
tespaganlluki	[Anaphor]^paagna(DEM.PRO.Abs.Sg)^[Sbrd.Trns]^[_.3Pl]
uyavaghaghllagumalghii	uyavagh(V)^–ghllagu(V→V)^@~:(i/u)ma(V→V)^[Ptcp.Intr]^[3Sg]
uyavaghaghllagumalghii	uyavagh(V)^–ghllagu(V→V)^@~:(i/u)ma(V→V)^[Ptcp.Intr]^[3Sg]
ivanghiighusimayaqangat	ivagh(V)^@–nghite(V→V)^@~:(i/u)ma(V→V)^@~fyagh(V→V)^@~–(g)kagh(V→N)^[Abs.3PlPoss.Sg]
ivanghiighusimayaqangat	ivagh(V)^@–nghite(V→V)^@~:(i/u)ma(V→V)^@~fyagh(V→V)^@~–(g)kagh(V→N)^[Abs.3PlPoss.Sg]
ivanghiighusimayaqangat	ivagh(V)^@–nghite(V→V)^@~:(i/u)ma(V→V)^@~fyagh(V→V)^@~–(g)kagh(V→N)^[Abs.3PlPoss.Sg]
asghaamakanga	esghagh(V)^@~:(i/u)ma(V→V)^[Ptcp.Trns]^[3Sg.3Sg]
taamnguq	taam(PTCL)^=nguq
taamnguq	taam(PTCL)^=nguq
piniqsaliiteghllagumakangak	?^–ghllag(V→V)^@~:(i/u)ma(V→V)^[Ptcp.Trns]^[3Du.3Sg]
piniqsaliiteghllagumakangak	?^–ghllag(V→V)^@~:(i/u)ma(V→V)^[Ptcp.Trns]^[3Du.3Sg]
ellngitni	ellngitni(PRO.Loc.3Pl)
kiyaghteghpakaamalghii	kiyaghte(V)^@–ghpagte(V→V)^@~:(i/u)ma(V→V)^[Ptcp.Intr]^[3Sg]
ivaagwaqeftaat	ivagh(V)^~:(ng)u(V→V)^~(g)aqe(V→V)^+(pete)fte(V→V)^[Ind.Trns]^[3Pl.3Sg]
ellmineng	ellmineng(PRO.Abl_Mod.4Sg)
neneghqestaaghhaaguq 	neneghqestaaghhagh*(N)^~:(ng)u(N→V)^[Ind.Intr]^[3Sg]
Angalgaaguq	Angalgagh(N)^~:(ng)u(N→V)^[Ind.Intr]^[3Sg]
Angalgaam	Angalgagh(N)^[Rel.Sg]
Angalgaq	Angalgagh(N)^[Abs.Sg]
Qaneghmiguq	Qaneghmig(N)^~:(ng)u(N→V)^[Ind.Intr]^[3Sg]
igaqegkanghhaqa 	igaqegkagh(N)^@–nghhagh(V→N)^[Abs.1SgPoss.Sg]
kanaghnnanighsigu 	kanaghte(V)^@~fnanigh(V→V)^[Intrg.Trns]^[2Sg.3Sg]
alpemenun 	alpem(N)^[All.Sg]
elpeneng 	elpeneng(PRO.Abl_Mod.2Sg)
ayemruugta 	ayemruugte(V)^[Abs.Sg]
meghnaalillu 	meghnaali(V)^[Abs.Sg]^=llu
sumeghtaghatkenanghisigu 	sumeghtaghagh(V)^@~:(u)tke(V→V)^@~fnanigh(V→V)^[Intrg.Trns.2Sg.3Sg]
sumeghtaghatkenanghisigu 	sumeghtaghagh(V)^@~:(u)tke(V→V)^@~fnanigh(V→V)^[Intrg.Trns.2Sg.3Sg]
Kerita	Kerita(N)^[Abs.Sg]
Keritam	Kerita(N)^[Rel.Sg]
angtilleghpeneng	angli(V)^–llegh(V→N)^[Abl_Mod.2SgPoss.Sg]
naay	naa(N)^[Voc.Sg]
kallagtaqaak	kallagte(V)^~(g)aqe(V→V)^[Ind.Trns]^[3Sg.3Du]
kallagtaqaak	kallagte(V)^~(g)aqe(V→V)^[Ind.Trns]^[3Sg.3Du]
Patim	Pati(N)^[Rel.Sg]
haluu	haalu(PTCL)
ataay	ata(N)^[Voc.Sg]
nunmaasqughhaq	nunmaakw(PTCL)^–squghhagh*(N→N)^[Abs.Sg]
krawna 	krawna(N)^[Abs.Sg]
tamaastaqi	tamaa(V)^+(te)ste(CmpdVbl)^~(g)aqe(V→V)^[Ind.Trns]^[3Sg.3Pl]
guutma 	ggute(N)^[Rel.1SgPoss.Pl]
krawnem	krawna(N)^[Rel.Sg]
Ggutlum	Ggutlu(N)^[Rel.Sg]
Qiitam	Qiitagh(N)^[Rel.Sg]
asiiliq	asiligh*(N)^[Abs.Sg]
kii-i	kii-i(XCLM)
Paapgaq	Paapgagh(N)^[Abs.Sg]
neqekaghqameng	neqe(N):^~–kaghqagh(N→N)^[Abl_Mod.Sg]
itghutaqitek 	itegh(V)^~:(ng)u(V→V)^+tagh(V→V)^[Ptcp.Trns]^[3Sg.2Du]
afsengaghniighusimeng	afsengagh*(N)^@~fniigh(N→V)^~:(u)sigh(V→N)^[Abl_Mod.Sg]
ungelekestaghhaamaghmi 	ungelegte(V)^–kestagh(V→V)^@~:(i/u)magh*(V→QUANTQUAL)^[4Sg]
ungelekestaghhaamaghmi 	ungelegte(V)^–kestagh(V→V)^@~:(i/u)magh*(V→QUANTQUAL)^[4Sg]
naaqerrewaaghumalghii 	naagh(V)^+regagh(V→V)^@~:(i/u)ma(V→V)^[Ptcp.Intr]^[3Sg]
naaqerrewaaghumalghii 	naagh(V)^+regagh(V→V)^@~:(i/u)ma(V→V)^[Ptcp.Intr]^[3Sg]
yuginniluku 	yug(N)^?^[Sbrd.Intr]^[4Sg]
ivaghiyaghnanighnayaghtunga 	ivagh(V)^~i(V→V)^@~fyagh(V→V)^@~fnanigh(V→V)^@~fnayagh(V→V)^[Ind.Intr]^[1Sg]
Paapgallegaghhaq 	Paapgagh(N)^–llegagh*(N→N)^–ghhagh*(N→N)^[Abs.Sg]
suumqeghpenakek 	suumqagh(N)^@–nghite(V→V)^[Sbrd.Trns]^[_.3Du]
suumqeghpenakek 	suumqagh(N)^@–nghite(V→V)^[Sbrd.Trns]^[_.3Du]
qiighnitaghamikun 	qiighnite(V)^+aagh(V→N)^[Prl.4SgPoss.Sg]
qiighnitaghamikun 	qiighnite(V)^+aagh(V→N)^[Prl.4SgPoss.Sg]
iingkugnun 	iingku(DEM.PRO)^[All.Du]
qugaagsighaq 	qugaagsighagh(V)^[Abs.Sg]
pugimnaqragkiighumayalghii 	pugime(V)^@~fnaqe(V→V)^@~f–ragkiigh(V→V)^@~:(i/u)ma(V→V)^[PtcpObl.Intr]^[3Sg]
alqutaghpagem 	alquutagh(V)^+pag(V→V)^[Rel.Sg]
alqutaghpagem 	alquutagh(V)^+pag(V→V)^[Rel.Sg]
mesaaqetun 	mesaagh(V)^[Equ.Sg]
mesaaqetun 	mesaagh(V)^[Equ.Sg]
nevuutaghamalghii 	nevuutagha(V)^@~:(i/u)ma(V→V)^[Ptcp.Intr]^[3Sg]
nevuutaghamikun 	nevuutagha(V)^[Prl.4SgPoss.Sg]
nevaghangitgun 	nevagha(V)^[Prl.3PlPoss.Sg]
mesaaq 	mesaagh(V)^[Abs.Sg]
aglamaluni 	aglagh(V)^@~:(i/u)ma(V→V)^[Sbrd.Intr]^[4Sg]
afsengaghestun 	afsengagh*(N)^[Equ.Du]
Kaasuq	Kaasugh(N)^[Abs.Sg]
Paapgaagunga 	Paapgagh(N)^~:(ng)u(N→V)^[Ind.Intr]^[1Sg]
Paapgaghunga 	Paapgagh(N)^~:(ng)u(N→V)^[Ind.Intr]^[1Sg]
guughngaghmi 	guugh(POS)^[Conc.Intr]^[4Sg]
guughngaghmi 	guugh(POS)^[Conc.Intr]^[4Sg]
ungipaasisteng 	ungipaate(V)^[Cnsq1.Trns]^[3Pl.4Pl]
ugharramun 	ugharre(N)^[All.Sg]
ugharratuqaq 	ugharre(N)^–tuqagh(N→N)^[Abs.Sg]
taam 	taam(PTCL)
ateqsunghisamigu	ategh(N)^@~fyug(N→V)^@–nghite(V→V)^[Cnsq1.Trns]^[4Sg.3Sg]
ateqsunghisamigu	ategh(N)^@~fyug(N→V)^@–nghite(V→V)^[Cnsq1.Trns]^[4Sg.3Sg]
aqniqhtuq	aqnighte(V)^[Ind.Intr]^[3Sg]
utaqigi 	utaqa(V)^[Opt.Pres.Intr.2Sg]
iqitesnaagha 	iqite(V)^+(te)ste(CmpdVbl)^@~fnaagh(V→V)^[Ind.Trns]^[3Sg.3Sg]
kiyaghtestaqi	kiyaghte(V)^+(te)ste(CmpdVbl)^~(g)aqe(V→V)^[Ind.Trns]^[3Sg.3Pl]
iiyegken 	iye(N)^[Abs.2SgPoss.Du]
ka-a	ka-a(XCLM)
quneghllukek	qunegh(POS)^+te(POS→ACTIVE)^[Sbrd.Trns]^[_.3Du]
iqitestagwu	iqite(V)^+(te)ste(CmpdVbl)^[Intrg.Trns]^[3Sg.3Sg]
supeliighmeng 	suupeliigh(N)^[Abl_Mod.Sg]
neqekranglaghtuq 	neqekrangllagh(V)^[Ind.Intr]^[3Sg]
taghnughaq 	taghnughhagh*(N)^[Abs.Sg]
aghvigimaghmeng	aghvig(V)^@~:(i/u)magh*(V→QUANTQUAL)^[4Pl]
tanughqimaghmeng 	tanughqe(V)^@~:(i/u)magh*(V→QUANTQUAL)^[4Pl]
Kapik	Kapig(N)^[Abs.Sg]
Kellum	Kellu(N)^[Rel.Sg]
Maasum	Maasu(N)^[Rel.Sg]
Paapam	Paapa(N)^[Rel.Sg]
Siksik	Siksig(N)^[Abs.Sg]
neqangiinnaqneghmegni 	neqe(N)^~:(ng)ite(N→V)^@~fnaqe(V→V)^@~f–negh(V→N)^[Loc.4PlPoss.Sg]
neqangiinnaqneghmegni 	neqe(N)^~:(ng)ite(N→V)^@~fnaqe(V→V)^@~f–negh(V→N)^[Loc.4PlPoss.Sg]
neqangiinnaqneghmegni 	neqe(N)^~:(ng)ite(N→V)^@~fnaqe(V→V)^@~f–negh(V→N)^[Loc.4PlPoss.Sg]
neqangiinnaqneghmegni 	neqe(N)^~:(ng)ite(N→V)^@~fnaqe(V→V)^@~f–negh(V→N)^[Loc.4PlPoss.Sg]
tuyeftupigniluni 	tuyeftu(V)^–pig(N→N)^@~fni(CmpdVbl)^[Sbrd.Intr]^[4Sg]
qenngiilliqepiglluni 	qenngulliqe(V)^–pigte(V→V)^[Sbrd.Intr]^[4Sg]
ggaatfaka 	ggate(N)^~f–vag(V→V)^[Abs.1SgPoss.Sg]
puughtingham 	puughte(V)^~i(V→V)^[Ctmp.Intr]^[3Sg]
kevgani 	keveg(V)^[Loc.3SgPoss.Sg]
umiillgaam 	umiillgagh*(N)^[Rel.Sg]
aglaasaghqameng 	aglaasaghqagh(N)^[Abl_Mod.Sg]
quyapigluni 	quya(V)^–pig(N→N)^[Sbrd.Intr]^[4Sg]
nemegnun 	ne(N)^[All.4PlPoss.Sg]
neghqwaghviggaanka 	?
taakunginaghaagneng 	?
esneghagnekun 	esneghagh(N)^[Prl.Du]
mataghlluni	matagh*(POS)^[Sbrd.Intr]^[4Sg]
ha	ha(XCLM)
haa	haa(XCLM)
pimyaqanga	pi(V)^@~:(i/u)ma(V→V)^[Ptcp.Trns]^[3Sg.3Sg]
sikughaghet 	sikughaagh(N)^[Abs.Pl]
agʼghiyugneghllak 	ag'ghiyugnegh(N)^–ghllag(N→N)^[Abs.Sg]
aaghnneghllugllak	aaghhneghllug(N)^–ghllag(N→N)^[Abs.Sg]
aaghnneghlliqumalghii 	aaghhneghlliqe(V)^@~:(i/u)ma(V→V)^[Ptcp.Intr]^[3Sg]
esnenqitni 	esne(N)^[Loc.3PlPoss.Sg]
saam	saam(PTCL)
aaghnneghlliqumazinga	aaghhneghlliqe(V)^@~:(i/u)ma(V→V)^[Intrg.Intr.1Sg]
aaghnneghlliqellghaneng 	aaghhneghlliqe(V)^–llegh(V→N)^[Abl_Mod.3SgPoss.Sg]
piniighqwaamakanga 	pinighqaa(V)^@~:(i/u)ma(V→V)^[Ptcp.Trns]^[3Sg.3Sg]
piniighqwaamakanga 	pinighqaa(V)^@~:(i/u)ma(V→V)^[Ptcp.Trns]^[3Sg.3Sg]
Kiiluum	Kiiluuq(N)^[Rel.Sg]
Kiiluuq	Kiiluuq(N)^[Abs.Sg]
leganʼnguq	legan(PTCL)=nguq
elqwaaghniighpenaniqagit	elqwaagh(N)^@~fniigh(N→V)^@–nghite(V→V)^[Sbrd.Intr]^[4Sg]
qagighllaguftughnguq	qagi(N)^–ghllag(N→N)^~:(ng)u(N→V)^+(pete)fte(V→V)^[Ind.Intr]^[3Sg]=nguq
Kulusiim	Kulusigh(N)^[Rel.Sg]
Kulusiimllu	Kulusigh(N)^[Rel.Sg]^=llu
Paansu	Paansu(N)^[Abs.Sg]
Kulusiim	Kulusigh(N)^[Rel.Sg]
Paansunkuk	Paansu(N)^~sf-w:(e)nku(N→N)^[Abs.Du]
ahulaquq	aghulaqe(V)^[Ind.Intr]^[3Sg]
Unuusisukanga	Unuusisukanga(N)^[Abs.Sg]
aanyugllaghngaaghmi	aane(V)^@~fyug(V→V)^–ghllag(V→V)^[Conc.Intr]^[4Sg]
qepuughluni	keptugh(V)^[Sbrd.Intr]^[4Sg]
aaghhwmeng	aaghhwe(V)^[Abl_Mod.Sg]
pegnenqegsaq	pegnem(PTCL)^@–nqegsagh(V→V)^[Abs.Sg]
qenaghugmun	qengaghug(N)^[All.Sg]
agaveqaaghaq	agaveqaaghaq(PTCL)
igkamsugmeng	igkamsug(V)^[Abl_Mod.Sg]
nengluminun	nenglu(N)^[All.4SgPoss.Sg]
anigutuumaghllaqmi	anigu(N)^+tuumagh*(N→QUANTQUAL)^–ghllag(N→N)^[Loc.Sg]
anigutuumaghllaqmi	anigu(N)^+tuumagh*(N→QUANTQUAL)^–ghllag(N→N)^[Loc.Sg]
itqaghlluni	itegh(V)^~–qaghte(V→V)^[Sbrd.Intr]^[4Sg]
tunutanganun	tunute(V)^[All.3SgPoss.Sg]
tunutanganun	tunute(V)^[All.3SgPoss.Sg]
kakavruugteghllak	kakavruugte(V)^–ghllag(V→N)^[Abs.Sg]
repallnguq	repall(PTCL)^=nguq
pekam	pekagh(V)^[Rel.Sg]
sangughIlak	sa(V)^~:(ng)u(V→V)^–ghllag(V→N)^[Abs.Sg]
tagiivaghhu	tagivagh(V)^[Opt.Pres.Trns.2Sg.3Sg]
sangwa	sa(V)^~:(ng)u(V→V)^[Intrg.Intr]^[3Sg]
ii	ii(PTCL)
qiyanaqumaghminguq	qiya(V)^@~fnaqe(V→V)^@~:(i/u)magh*(V→QUANTQUAL)^[4Sg]^=nguq
gaallghaagken	gaagh(V)^–llegh(V→N)^~:(ng)u(N→V)^[Ind.Trns]^[3Pl.3Du]
talaghillghiim	talaghitagh(V)^@–lghii(V→N)^[Rel.Sg]
Unuusisukangam	Unuusisukanga(N)^[Rel.Sg]
ipesaghaaghumaa	ipeg(V)^+saghagh(CmpdVbl)^@~:(i/u)ma(V→V)^[Ind.Trns]^[3Sg.3Sg]
hee	hee(XCLM)
gaallghaagket	gaagh(V)^–llegh(V→N)^~:(ng)u(N→V)^[Ind.Trns]^[2Sg.3Du]
awatangitnilghuuk	awate(N)^[Abs.3PlPoss.Pl]^?
kinatuq 	kina(WH)^[Ind.Intr]^[3Sg]
kinatuq 	kina(WH)^[Ind.Intr]^[3Sg]
ulleghaatut	ullegh(V)^?^[Ind.Intr]^[3Pl]
kelqaak 	kelqe(V)^[Ind.Trns]^[3Sg.3Du]
siingaak	siinge(V)^[Ind.Trns]^[3Sg.3Du]
haam	haam(XCLM)
hu	hu(XCLM)
Kanullu	Kanu(N)^[Abs.Sg]=llu
Tati	Tati(N)^[Abs.Sg]
Tatim	Tati(N)^[Rel.Sg]
Tinanum	Tinana(N)^[Rel.Sg]
eskiitaak	eskiite(V)^[Ind.Intr]^[3Du]
piltungi	pi(V)^?^[Opt.Pres.Intr.2Sg]
nagaqughsigu-u	nagaqugh(V)^[Intrg.Trns]^[2Sg.3Sg]
hilikaptera	hilikaptera(N)^[Abs.Sg]
quneghtaqatkii	qunegh(POS)^+te(POS→ACTIVE)^~(g)aqe(V→V)^[Intrg.Trns]^[3Pl.3Pl]
nuyeklliigut 	nuyekligh(N)^~:(ng)u(N→V)^[Ind.Intr]^[3Pl]
yugsugnightestaqii 	yugsugnite(V)^+(te)ste(CmpdVbl)^~(g)aqe(V→V)^[Ind.Trns]^[3Sg.3Pl]
taakughfaqut	taake(V)^~:(ng)ughte(N→V)^~(g)aqe(V→V)^[Ind.Intr]^[3Pl]
nersa	nerse(N)^[Abs.Sg]
nersem	nerse(N)^[Rel.Sg]
iikesnaqaqaak	iike(V)^+(te)ste(CmpdVbl)^@~fnaqe(V→V)^~(g)aqe(V→V)^[Ind.Trns]^[3Sg.3Du]
tamanganun	tamaghhagh*(QUANTQUAL)^[All.3SgPoss.Sg]
Tamniim	Tamnigh(N)^[Rel.Sg]
haaspetel-mi	hospital(N)^[Loc.Sg]
estugaghlleghi 	estugagh(N)^–llegh(V→N)^[Loc.Sg]
tuuna 	tuune(V)^[Ind.Trns]^[3Sg.3Sg]
kugarameng 	kugara(N)^[Abl_Mod.Sg]
ketanquq 	ketanqu(V)^[Ind.Intr]^[3Sg]
tukfighileqa 	tukfigh(V)^@lleqe(V→V)^[Intrg.Intr]^[3Sg]
kavighet 	kaviigh(N)^[Abs.Pl]
elpaak	elpek(PRO.AbsRel.2Sg)
Piisam	Piisagh(N)^[Rel.Sg]
Piisaq	Piisagh(N)^[Abs.Sg]
yataaghqaqaghput	yataaghqe(V)^~(g)aqe(V→V)^@~–(g)kagh(V→N)^[Abs.1PlPoss.Pl]
yataaghqaqaghput	yataaghqe(V)^~(g)aqe(V→V)^@~–(g)kagh(V→N)^[Abs.1PlPoss.Pl]
piitesiighallghem	piitesighagh(V)^–llegh(V→N)^[Rel.Sg]
tengtekayugii	tenge(V)^@~–(g)kayugu(V→V)^[Ind.Trns]^[3Sg.3Pl]
tengtekayugii	tenge(V)^@~–(g)kayugu(V→V)^[Ind.Trns]^[3Sg.3Pl]
iirmi	iir(N)^[Loc.Sg]
cabbage-t	cabbage(N)^[Abs.Pl]
garden-mi	garden(N)^[Loc.Sg]
puqlalghiimi	puqlate(V)^@–lghii(V→N)^[Loc.Sg]
desert-mi	desert(N)^[Loc.Sg]
piitesiighaam	piitesighagh(N)^[Rel.Sg]
piitesiighaam	piitesighagh(N)^[Rel.Sg]
Venus	Venus(N)^[Abs.Sg]
fly	fly(N)^[Abs.Sg]
trap-a	trap(N)^[Abs.Sg]
neqekelghi	neqe(N)^@~–(g)ke(V→N)^[Ptcp.Intr]^[3Sg]
neqekelghi	neqe(N)^@~–(g)ke(V→N)^[Ptcp.Intr]^[3Sg]
neghigkayuget	neghe(V)^~–kayug(V→N)^[Rel.Pl]
petgankut	petgagh(V)^~sf-w:(e)nku(N→N)^[Abs.Pl]
nuyaaghenkut	nuyaagh(V)^~sf-w:(e)nku(N→N)^[Abs.Pl]
legrengiighhaankut	legre(V)^~fngiighhagh*(N→N)^~sf-w:(e)nku(N→N)^[Abs.Pl]
nalughqutavalluq	nalughqutagh(V)^~f(p/v)allugh(N→N)^[Abs.Sg]
nalughqutavalluq	nalughqutagh(V)^~f(p/v)allugh(N→N)^[Abs.Sg]
nuyaaq	nuyaagh(V)^[Abs.Sg]
legrengiighhaq	legre(V)^~fngiighhagh*(N→N)^[Abs.Sg]
igleghhneghpalluq	igleghte(V)^@~f–negh(V→N)^~f(p/v)allugh(N→N)^[Abs.Sg]
piigelghiit	?
kaaluku	kaate(V)^[Sbrd.Trns]^[_.3Sg]
tagilaghaasimalghiit	tagi(V)^~f–laghate(V→V)^@~:(i/u)ma(V→V)^[Ptcp.Intr]^[3Pl]
petgam	petgagh(V)^[Rel.Sg]
legrengiighhaam	legre(V)^~fngiighhagh*(N→N)^[Rel.Sg]
kaannaqngisteng	kaate(V)^@~fnaqe(V→V)^[Conc.Trns]^[3Sg.4Pl]
metghaghneng	metghagh(N)^[Abl_Mod.Pl]
ugavaghamalghiit	ugavagh(V)^@~:(i/u)ma(V→V)^[Ptcp.Intr]^[3Pl]
ugavaghamalghiit	ugavagh(V)^@~:(i/u)ma(V→V)^[Ptcp.Intr]^[3Pl]
reghiteftuk	reghete(V)^+(pete)fte(V→V)^[Ind.Intr]^[3Du]
igleghtem	igleghte(V)^[Rel.Sg]
Tinanankuk	Tinana(N)^~sf-w:(e)nku(N→N)^[Abs.Du]
Ipinkuk	Ipi(N)^~sf-w:(e)nku(N→N)^[Abs.Du]
Tinanam	Tinana(N)^[Rel.Sg]
pitta	pite(V)^[Ind.Trns]^[3Sg.3Sg]
Ipim	Ipi(N)^[Rel.Sg]
Simam	Sima(N)^[Rel.Sg]
angeghyesteng	angegh(V)^[Cnsq1.Trns]^[3Sg.4Pl]
piitesiighaghmeng	piitesighagh(N)^[Abl_Mod.Sg]
piitesiighaghmeng	piitesighagh(N)^[Abl_Mod.Sg]
Simankuk	Sima(N)^~sf-w:(e)nku(N→N)^[Abs.Du]
Sima	Sima(N)^[Abs.Sg]
Tinana	Tinana(N)^[Abs.Sg]
mangtaaghhat	mangteghagh(N)^[Abs.Pl]
qafsinwaat	qafsineg(WH)^~:(ng)u(N→V)^[Ind.Trns]^[3Pl.3Sg]
takwaaghaataghnaluki	[Anaphor]^uka(DEM.ADV)^+aghaghte(V→V)^[Sbrd.Trns]^[_.3Pl]
takwaaghaataghnaluki	[Anaphor]^uka(DEM.ADV)^+aghaghte(V→V)^[Sbrd.Trns]^[_.3Pl]
aghhutanga	aghhutanga tamaghhaan(PTCL)
tamaghhan	tamaghhagh*(QUANTQUAL)^[3Sg]
aaghhwmeng	aaghhwe(V)^[Abl_Mod.Sg]
Patam	Pata(N)^[Rel.Sg]
ii	ii(PTCL)
Ipi	Ipi(N)^[Abs.Sg]
saaghwinun	saaghw(AREA)^[All.Pl]
sanivaghluteng	sanivagh(V)^[Sbrd.Intr]^[4Pl]
saaghwini	saaghw(AREA)^[Loc.Pl]
ataasikaghtaan	ataasigh(NUM)^+kaghtagh(DEM→N)^[Rel.3SgPoss.Sg]
Patankut	Pata(N)^~sf-w:(e)nku(N→N)^[Abs.Pl]
naasqwit	naasqugh(N)^[Abs.3PlPoss.Pl]
wha-a	wha-a(XCLM)
naantefta	na(WH)^?^+(pete)fte(V→V)^[Intrg.Intr]^[3Sg]
maligtemmeng	malighte(V)^[Abl_Mod.Sg]
kamerragem	kamek(N)^–raagh(N→N)^[Rel.Sg]
ayemtaasaghtuultegneki	ayemte(V)^+saghtugh(V→V)^[Opt.Pres.Trns]^[1Du.3Pl]
ghumalghii	ighsa(V)^~–(ghw/ngw/w)aagh(V→V)^@~:(i/u)ma(V→V)^[Ptcp.Intr]^[3Sg]
amestaapigtuk	amestaagh(V)^–pigte(V→V)^[Ind.Intr]^[3Du]
esghamsiighwaghluni	esghagh(V)^–msiigh(V→V)^~–(ghw/ngw/w)aagh(V→V)^[Sbrd.Intr]^[4Sg]
quneghqelluni	qunegh(POS)^+qe(V→V)^[Sbrd.Intr]^[4Sg]
ullghitaperegwaaghumaghmi	ullghitagh(V)^–perewaagh(V→N)^@~:(i/u)magh*(V→QUANTQUAL)^[4Sg]
ullghitaperegwaaghumaghmi	ullghitagh(V)^–perewaagh(V→N)^@~:(i/u)magh*(V→QUANTQUAL)^[4Sg]
pagunʼghameng	pagunghagh*(N)^[Abl_Mod.Sg]
pagunʼghameng	pagunghagh*(N)^[Abl_Mod.Sg]
ugpeghqwaamakanga	ugpegh(V)^~–(ghw/ngw/w)aagh(V→V)^@~:(i/u)ma(V→V)^[Ptcp.Trns]^[3Sg.3Sg]
ugpeghqwaamakanga	ugpegh(V)^~–(ghw/ngw/w)aagh(V→V)^@~:(i/u)ma(V→V)^[Ptcp.Trns]^[3Sg.3Sg]
uyghamqiighaghhaghmeng	uyghamqiighwagh(N)^[Abl_Mod.Sg]
uqigtulngiighhaghmitun	uqigtutala(N)^~fngiighhagh*(N→N)^[Equ.4SgPoss.Sg]
aliinghakuun	aliinegh(N)^[Prl.3SgPoss.Sg]
ellmeggneng	ellmeggneng(PRO.Abl_Mod.4PlPoss.Sg)
atighlleqaghput	atigh(V)^–lleghqagh(V→N)^[Abs.1PlPoss.Sg]
enkam	enkaam(PTCL)
tagnetghii	tagnegh(V)^[Ptcp.Intr]^[3Sg]
oawaagpagenkut	qawaagpag(N)^~sf-w:(e)nku(N→N)^[Abs.Pl]
oawaagpagnguq	qawaagpag(N)^[Abs.Sg]^=nguq
oatelghii	qategh(V)^[Ptcp.Intr]^[3Sg]
allgha	aag(V)^-llegh(V→N)^[Abs.3SgPoss.Sg]
Kulusiim	Kulusigh(N)^[Rel.Sg]
Paansu	Paansu(N)^[Abs.Sg]
Paansum	Paansu(N)^[Rel.Sg]
Kulusighmun	Kulusigh(N)^[All.Sg]
Paansullu	Paansu(N)^[Abs.Sg]^=llu
Paansunkuk	Paansu(N)^~sf-w:(e)nku(N→N)^[Abs.Du]
ukazig	ukazigh(N)^[Abs.Sg]
Takunkut	Taku(N)^~sf-w:(e)nku(N→N)^[Abs.Pl]
aflengakaghnaketen	aflengake(V)^[Opt.Fut.Trns]^[2Sg.3Pl]
tallimaguut	tallimat(NUM)^[Ind.Intr]^[3Pl]
Takum	Taku(N)^[Rel.Sg]
number-a	number(N)^[Abs.Sg]
teruwiteggu	terugi(V)^[Opt.Pres.Trns]^[2Pl.3Sg]
qasigaghhaam	qasiqagh(N)^–ghhagh*(N→N)^[Rel.Sg]
qungluk	qunglug(V)^[Abs.Sg]
mekestaaghhalghii	mekestaaghhagh*(N)^@–lghii(V→N)^[Abs.Sg]
pugimenghani	pugime(V)^[Ctmp.Intr]^[3Sg]
uyaqwhakun	uyaqugh(N)^[Prl.Sg]
nuqnneghluni	nuqnegh(V)^[Sbrd.Intr]^[4Sg]
qunglugem	qunglug(V)^[Rel.Sg]
pugimenghata	pugime(V)^[Ctmp.Intr]^[3Pl]
esghapagaqeggkani	esghapag(V)^~(g)aqe(V→V)^@~–(g)kagh(V→N)^[Loc.Pl]
ellngallutughnguq	ellnga(PRO.Abs.3Sg)^=llu^=tugh^=nguq
pugimameng	pugimagh(V)^[Abl_Mod.Sg]
isiqetun	siqi(V)^[Equ.Sg]
isiqetun	siqi(V)^[Equ.Sg]
qavamaluku	qavagh(V)^@~:(i/u)ma(V→V)^[Sbrd.Trns]^[_.3Sg]
puwiimaghnaluni	pugimagh(V)^@~fna(V→V)^[Sbrd.Intr]^[4Sg]
puwiimaghnaluni	pugimagh(V)^@~fna(V→V)^[Sbrd.Intr]^[4Sg]
sumeghtaghamelghii	sumeghtaghagh(V)^@~:(i/u)ma(V→V)^[Ptcp.Intr]^[3Sg]
sumeghtaghamelghii	sumeghtaghagh(V)^@~:(i/u)ma(V→V)^[Ptcp.Intr]^[3Sg]
isiqughhusimalghii	isiqghuute(V)^@~:(i/u)ma(V→V)^[Ptcp.Intr]^[3Sg]
isiqghhuutelgha	isiqghuute(V)^–llegh(V→N)^[Abs.3SgPoss.Sg]
isiqghhuutelgha	isiqghuute(V)^–llegh(V→N)^[Abs.3SgPoss.Sg]
pugimemeng	pugime(V)^[Abl_Mod.Sg]
angliighataaghaqumi	?
apeghtuqangani	apeghtugh(V)^+tuqagh(V→N)^[Loc.3SgPoss.Sg]
nenglekegmun	nenglekegte(V)^[All.Sg]
upenghaam	upenghagh(N)^[Rel.Sg]
nunmaaggaq	nunmaaggaq(PTCL)
sivutmiightageftuq	sivu(AREA)^+tmiigh(DEM→V)^?^~(g)aqe(V→V)^+(pete)fte(V→V)^[Ind.Intr]^[3Sg]
mekestaaghalghii	mekestaaghhaa(V)^[Ptcp.Intr]^[3Sg]
Rudolph	Rudolph(N)^[Abs.Sg]
Rudolph-nguuq	Rudolph(N)^~:(ng)u(N→V)^[Ind.Intr]^[3Sg]
kalereqnakesi	kalereqe(V)^[Opt.Fut.Trns]^[2Pl.3Pl]
mekelghlighhaatlu 	mekelghiigh(N)^–ghhagh*(N→N)^[Abs.Pl]^=llu
tamangani	tamaghhagh*(QUANTQUAL)^[Loc.3SgPoss.Sg]
tamangani	tamaghhagh*(QUANTQUAL)^[Loc.3SgPoss.Sg]
kalereqiteggu	kalereqe(V)^[Opt.Pres.Trns]^[2Pl.3Sg]
Rudolph-em	Rudolph(N)^[Rel.Sg]
taakutiu	[Anaphor]^uku(DEM.PRO)^[AbsRel.Pl]^=llu
aleghqughyuqaqegkangi 	aleghqugh(V)^@~f–yuqagh(V→N)^?^[Ptcp.Trns]^[3Sg.3Pl]
tamaanlenguut	[Anaphor]^maa(DEM.ADV)^?^[Ind.Intr]^[3Pl]
atuneghqulluteng	atune(N)^–ghqu(N→V)^[Sbrd.Intr]^[4Pl]
kalereqiteki	kalereqe(V)^[Opt.Pres.Trns]^[2Pl.3Pl]
pazelem 	pazel(N)^[Rel.Sg]
tegh	teghig(EMO)^@~fnagh(EMO→N)^+tu(N→V)^[Opt.Pres.Trns]^[1Sg.3Pl]
ignaghtu	teghig(EMO)^@~fnagh(EMO→N)^+tu(N→V)^[Opt.Pres.Trns]^[1Sg.3Pl]
iangi	teghig(EMO)^@~fnagh(EMO→N)^+tu(N→V)^[Opt.Pres.Trns]^[1Sg.3Pl]
pazelet	pazel(N)^[Abs.Pl]
amestaaghhaat	amestaagh(V)^~:(ng)u(N→V)^[Ind.Intr]^[3Pl]
taakwagun 	[Anaphor]^ukagun(DEM.ADV.Prl)
iiisimakegkaghsi	liisimake(V)^@~–(g)kagh(V→N)^[Abs.2PlPoss.Sg]
tegmkusat 	teghikusagh(N)^[Abs.Pl]
uvitangani	uvita(N)^[Loc.3SgPoss.Sg]
latat	lata(N)^[Abs.Pl]
nampangitgun	nampe(N)^[Prl.3PlPoss.Sg]
maalghut	maalghug(NUM)^[Abs.Pl]
iighngalghlit 	iigh(V)^~fnga(V→V)^[Ptcp.Intr]^[3Pl]
metghaaghragenkut 	metghaghrag(N)^~sf-w:(e)nku(N→N)^[Abs.Pl]
kaleremeng 	kalere(N)^[Abl_Mod.Sg]
imighteqqu 	imigh(V)^[Opt.Pres.Trns]^[2Pl.3Sg]
qamaqlluku 	qamagte(V)^[Sbrd.Trns]^[_.3Sg]
Rudolph-enkut 	Rudolph(N)^~sf-w:(e)nku(N→N)^[Abs.Pl]
tunusaawaqelghii 	tunusagh(N)^~(g)aqe(V→V)^[Ptcp.Intr]^[3Sg]
tunusaawaqelghii 	tunusagh(N)^~(g)aqe(V→V)^[Ptcp.Intr]^[3Sg]
tunusaawaqelghii 	tunusagh(N)^~(g)aqe(V→V)^[Ptcp.Intr]^[3Sg]
Rudolph-mun	Rudolph(N)^[All.Sg]
Uulu 	Uulu(N)^[Abs.Sg]
Nome-emun	Nome(N)^[All.Sg]
Nuumennaqumalghii 	Nome(N)^[All.Sg]^@~fnaqe(V→V)^@~:(i/u)ma(V→V)^[Ptcp.Intr]^[3Sg]
Uulumennaluni	Uulu(N)^[All.Sg]^@~fna(V→V)^[Sbrd.Intr]^[4Sg]
taghnuqhhaat	taghnughhagh*(N)^[Abs.Pl]
tawatelgutkutngwaalghiik	tawate(V)^–lgutke(V→V)^@~:(u)te(V→V)^~–(ghw/ngw/w)aagh(V→V)^[Ptcp.Intr]^[3Du]
naalkennaaghestekaak	naalke(V)^@~fnaagh(V→V)^[Intrg.Trns]^[2Du.3Du]
naalkennaaghestekaak	naalke(V)^@~fnaagh(V→V)^[Intrg.Trns]^[2Du.3Du]
iksemeng 	ikse(N)^[Abl_Mod.Sg]
ghhughh	ghhughh(PTCL)
suumelghghiimeng	suume(V)^@–lghii(V→N)^[Abl_Mod.Sg]
awiitngaghpesi 	awite(V)^[Conc.Intr]^[2Pl]
awiitngaghpesi 	awite(V)^[Conc.Intr]^[2Pl]
puliismengan 	puliismen(N)^[Rel.3SgPoss.Sg]
iigi	iigge(N)^[Abs.3SgPoss.Pl]
iigi	iigge(N)^[Abs.3SgPoss.Pl]
aghulatepiglleghhistun	aghulate(V)^–pig(N→N)^–llegh(V→N)^[Equ.Pl]
nenglaasimaghmeng 	nenglaghsiigh(V)^@~:(i/u)magh*(V→QUANTQUAL)^[Abl_Mod.Sg]
nenglaasimaghmeng 	nenglaghsiigh(V)^@~:(i/u)magh*(V→QUANTQUAL)^[Abl_Mod.Sg]
Uulum	Uulu(N)^[Rel.Sg]
tunusalguftuq 	tuunusagh(N)^–lgu(N→V)^+(pete)fte(V→V)^[Ind.Intr]^[3Sg]
pazelkun	pazel(N)^[Prl.Sg]
Rudolph-et 	Rudolph(N)^[Abs.Pl]
kalereqfiget	kalereqe(V)^@~fvig(V→N)^[Abs.Pl]
neghqiyuneghtuqaq 	neghqe(V)^@~fyuneghtu(V→V)^+tuqagh(V→N)^[Abs.Sg]
neghqiyuneghtuqaq 	neghqe(V)^@~fyuneghtu(V→V)^+tuqagh(V→N)^[Abs.Sg]
ellnganeng	ellnganeng(PRO.Abl_Mod.3Pl)
peghnakesi 	peghte(V)^[Opt.Fut.Trns]^[2Pl.3Pl]
nanglekilleghmeng 	nanglleg(EMO)^–llegh(V→N)^[Abl_Mod.Sg]
nanglekilleghmeng 	nanglleg(EMO)^–llegh(V→N)^[Abl_Mod.Sg]
uqiitaghvigkameng	uqiitagh(V)^@~fvig(V→N)^+kagh(N→N)^[Abl_Mod.Sg]
naghaaq	naghaagh(V)^[Abs.Sg]
aqnightefqaayek	aqnighte(V)^[Opt.Neg.Pres.Trns]^[2Sg.3Du]
qiipsaghqaqagka	qiipe(V)^@~fyaghqagh(V→N)^[Abs.1SgPoss.Du]
ritiguk	ritigu(N)^[Abs.Du]
natelnguut	natelngu(V)^[Ind.Intr]^[3Pl]
ellngani	ellngani(PRO.Loc.3Sg)
nalughqaghsimalghii	nalug(V)^~–qaghte(V→V)^@~:(i/u)ma(V→V)^[Ptcp.Intr]^[3Sg]
nalughqaghsimalghii	nalug(V)^~–qaghte(V→V)^@~:(i/u)ma(V→V)^[Ptcp.Intr]^[3Sg]
tawanlenguq	tawanlenguq(PTCL)
aghulaaqsiin	aghula(V)^~(g)aqe(V→V)^[Intrg.Intr.2Sg]
qughlung	qughlung(XCLM)
qung	qung(XCLM)
meteghllgrugnguq	meteghllug(N)^–ghrug(N→N)^[Abs.Sg]^=nguq
quneghqennallgha	qunegh(POS)^?^–llegh(V→N)^[Abs.3SgPoss.Sg]
quunghaghsimalghii	qunegh(POS)^~aghte(V→V)^@~:(i/u)ma(V→V)^[Ptcp.Intr]^[3Sg]
quneghqelluni	qunegh(POS)^+qe(V→V)^[Sbrd.Intr]^[4Sg]
sikiggaghngug	sikig(N)^–ghhagh*(N→N)^[Abs.Sg]^=nguq
itqaghsimalghii	?^@~:(i/u)ma(V→V)^[Ptcp.Intr]^[3Sg]
neghyaghaaq	negh(V)^@~fyaghqagh(V→N)^[Abs.Sg]
univagem	nunivag(N)^[Rel.Sg]
iwughtellghanun	igughte(V)^–llegh(V→N)^[All.3SgPoss.Sg]
akumemeng	akume(N)^[Abl_Mod.Sg]
qallaauqaq	qallaqugh(V)^@~–(g)kagh(V→N)^[Abs.Sg]
akumutngwaaghyaghqaq	akume(N)^?^~–(ghw/ngw/w)aagh(V→V)^@~fyaghqagh(V→N)^[Abs.Sg]
uughsaghngaan	?
yagkelengestaaghaan	yagkelengestaaghaagh(N)^[Rel.3SgPoss.Sg]
aavgughaaqaq	?
alquutaghpagem	alquutagh(N)^+pag(V→V)^[Rel.Sg]
yagkelengestaaghaq	yagkelengestaaghaagh(N)^[Abs.Sg]
mekitgughmelngughmun	mekitkughmete(V)^@ngugh(V→N)^[All.Sg]
yagkelengestaaghaaghtellghanun	yagkelengestaaghaaghte(V)^–llegh(V→N)^[All.3SgPoss.Sg]
aakwlu	aaw(N)^[Abs.Sg]^=llu
tawavek	[Anaphor]^awavek(DEM.ADV.All)
akumutngwaallghanun	akume(N)^?^~–(ghw/ngw/w)aagh(V→V)^–llegh(V→N)^[All.3SgPoss.Sg]
aavgughaaghyaghqaq	?^@~fyaghqagh(V→N)^[Abs.Sg]
alnguunak	alngunak(PTCL)
nunmaaggaq	nunmaaggaq(PTCL)
alquutasqughaat	alquutagh(N)^–squghhagh*(N→N)^[Abs.Pl]
mekestaaghaaluku	mekestaaghhaa(V)^[Sbrd.Trns]^[_.3Sg]
akusaghqaq	akusaghqagh(N)^[Abs.Sg]
igughnegha	?
paguneghqelluku	paguneghqe(V)^[Sbrd.Trns]^[_.3Sg]
eslevaghaghtun	eslevagagh(N)^[Equ.Sg]
yataaghqesaghqaq	yataaghqe(V)^@~fyaghqagh(V→N)^[Abs.Sg]
kemeghqesaghqaq	kemeghqe(V)^@~fyaghqagh(V→N)^[Abs.Sg]
yataaghqelgha	yataaghqe(V)^–llegh(V→N)^[Abs.3SgPoss.Sg]
sasqughaaluku	sa(N)^–squghhagh*(N→N)^[Sbrd.Trns]^[_.3Sg]
sasqughaaluku	sa(N)^–squghhagh*(N→N)^[Sbrd.Trns]^[_.3Sg]
larda	lard(N)^[Abs.Sg]
kaagtughluku	?^[Sbrd.Trns]^[_.3Sg]
gaaregaghluku	gaagh(V)^+regagh(V→V)^[Sbrd.Trns]^[_.3Sg]
lardkun	lard(N)^[Prl.Sg]
aghevestaghaq	aghevestaaghagh*(N)^[Abs.Sg]
lardmeng	lard(N)^[Abl_Mod.Sg]
ughvegkun	ughvig(N)^[Prl.Sg]
yagkelengestaaghaaluku	yagkelengestaaghaagh(V)^[Sbrd.Trns]^[_.3Sg]
neqanganeng	neqe(N)^[Abl_Mod.3SgPoss.Pl]
aghevelengestaaghaghmeng	?^[Abl_Mod.Sg]
uughugutkelluku	suughuute(V)^@~:(u)tke(V→V)^[Sbrd.Trns]^[_.3Sg]
sasqughaghmeng	sa(N)^–squghhagh*(N→N)^[Abl_Mod.Sg]
rnesi	mesiigh(N)^[Abl_Mod.3SgPoss.Sg]
rnesi	mesiigh(N)^[Abl_Mod.3SgPoss.Sg]
ighaneng	mesiigh(N)^[Abl_Mod.3SgPoss.Sg]
tawatengngwaaq	tawatengwaaq(PTCL)
neqnga	neqe(N)^[Abs.3SgPoss.Sg]
neqetaaghasaghqaq	neqete(V)^?^@~fyaghqagh(V→N)^[Abs.Sg]
neghegkayuk	neghe(V)^~–kayug(V→N)^[Abs.Sg]
iqalluwaq	iqallugagh(N)^[Abs.Sg]
taam	taam(PTCL)
neqanganun	neqe(N)^[All.3SgPoss.Sg]
ilatepanghelkufsigu	ilate(V)^–panghite(V→V)^[Cond.Trns]^[2Pl.3Sg]
qamagtenngwaaghluni	qamagte(V)^~–(ghw/ngw/w)aagh(V→V)^[Sbrd.Intr]^[4Sg]
unaqusiikufsigu	?^[Cond.Trns]^[2Pl.3Sg]
maalghum	maalghug(NUM)^[Rel.Sg]
yagkelengestaaghaaiuku	yagkelengestaaghaagh(V)^[Sbrd.Trns]^[_.3Sg]
yagkelengestaaghaaiuku	yagkelengestaaghaagh(V)^[Sbrd.Trns]^[_.3Sg]
haaspetela	haaspetel(N)^[Abs.Sg]
naqatusik	nagatusigh(N)^[Abs.Sg]
aampyulensek	aampyulense(N)^[Abs.Du]
waatsek	waate(N)^[Abs.Du]
whaa-a	whaa(PTCL)
ii-ii-uuu	ii-ii-uuu(XCLM)
ellmiineng	ellmineng(PRO.Abl_Mod.4Sg)
neghaqi	neghe(V)^~(g)aqe(V→V)^[Opt.Pres.Intr.2Sg]
naghaaghaqi	naghaagh(V)^~(g)aqe(V→V)^[Opt.Pres.Intr.2Sg]
qavaghaqi	qavagh(V)^~(g)aqe(V→V)^[Opt.Pres.Intr.2Sg]
Tafi	Tafi(N)^[Abs.Sg]
anglegutangi	anglegute(N)^[Abs.3SgPoss.Pl]
tagilaghaalluteng	tagi(V)^~f–laghate(V→V)^[Sbrd.Intr]^[4Pl]
takum	[Anaphor]^uku(DEM.PRO)^[Rel.Sg]
Tallingunaquq	Talli(N)^~:(ng)u(N→V)^@~fnaqe(V→V)^[Ind.Intr]^[3Sg]
tallimaguut	tallimat(NUM)^~:(ng)u(N→V)^[Ind.Intr]^[3Pl]
teruwiteggu	terugi(V)^[Opt.Pres.Trns]^[2Pl.3Sg]
Talli	Talli(N)^[Abs.Sg]
tallimaneng	tallimat(NUM)^[Abl_Mod.Sg]
esghagh-yaghtuqaghtegguqun	esghagh(V)^@~fyaghtuqagh(V→V)^[Opt.Pres.Trns]^[2Pl.3Sg]=qun
goldfishet	goldfish(N)^[Abs.Pl]
tertelet	tertele(N)^[Abs.Pl]
tadpolet	tadpole(N)^[Abs.Pl]
chickenet	chicken(N)^[Abs.Pl]
ataasikaghtaghhaan	ataasigh(NUM)^+kaghtagh(DEM→N)^–ghhagh*(N→N)^[Rel.3SgPoss.Sg]
froget	frog(N)^[Abs.Pl]
maantaqut	?^[Ind.Intr]^[3Pl]
naayvaghaaghni	naayvaghagh(N)^[Loc.3SgPoss.Sg]
robin-et	robin(N)^[Abs.Pl]
prairie	prairie(N)^[Abs.Sg]
dog-et	dog(N)^[Abs.Pl]
desert-mi	desert(N)^[Loc.Sg]
jungle-mi	jungle(N)^[Loc.Sg]
teghigniqumalciku	teghigniqe(V)^@~:(i/u)ma(V→V)^[Sbrd.Trns]^[_.3Sg]
ketfiighwaghlleghhii	ketfiighwaghte(V)^[Ptcp.Intr]^[3Sg]
uvitangani	uvita(N)^[Loc.3SgPoss.Sg]
ketfiighwaghtuq	ketfiighwaghte(V)^[Ind.Intr]^[3Sg]
uvitangakun	uvita(N)^[Prl.3SgPoss.Sg]
taghtuvalluq	taghtu(N)^~f(p/v)allugh(N→N)^[Abs.Sg]
aqsagken-taghtugken	taghtu(N)^[Abs.2SgPoss.Du]
aqsagken-taghtugken	aqsa(N)^[Abs.2SgPoss.Du]
qinuyagullukii	qinuyug(V)^@~:(u)te(V→V)^[Sbrd.Trns]^[_.3Pl]
qinuyagullukii	qinuyug(V)^@~:(u)te(V→V)^[Sbrd.Trns]^[_.3Pl]
paaggurugllak	?^–ghllag(N→N)^[Abs.Du]
qemallnguq	qemall(PTCL)^=nguq
kinaatelleqaangaa	kinegh(V)^?^@lleqe(V→V)^[Ind.Trns]^[3Sg.1Sg]
atetingaa	ategh(V)^?^[Ind.Trns]^[3Sg.1Sg]
palaghhaghmeng	palaghhagh(N)^[Abl_Mod.Sg]
igleghaghtaghllak	iglegha(V)^+(s)ta(V→N)^–ghllag(N→N)^[Abs.Sg]
amyughaaghusini	amyughaagh(V)^~:(u)sigh(V→N)^[Loc.Pl]
almesiqlluku	almesiqe(V)^[Sbrd.Trns]^[_.3Sg]
qinunaghalghii	qinunaghqe(V)^[Ptcp.Intr]^[3Sg]
haluu	haluu(PTCL)
Patu	Patu(N)^[Abs.Sg]
whanganguuq	whanga(PRO.AbsRel.1Sg)^~:(ng)u(V→V)^[Ind.Intr]^[3Sg]
naay	naa(N)^[Voc.Sg]
nengllugutkaghput	nengllugute(N)^+kagh(N→N)^[Abs.1PlPoss.Sg]
taaghen	taagken(PTCL)
elInga	ellnga(PRO.Abs.3Sg)
nuyeklighmun	nuyekligh(N)^[All.Sg]
nuyikliiguq	nuyekligh(N)^~:(ng)u(N→V)^[Ind.Intr]^[3Sg]
nengllugutelguaq	nengllugute(N)^–lgu(N→V)^[Ind.Intr]^[3Sg]
nengllugutkangaa	nengllugute(N)^~–ke(N→V)^[Intrg.Trns]^[3Sg.1Sg]
nengllugutelwaa	nengllugute(N)^–lgu(N→V)^[Intrg.Intr]^[3Sg]
N	N
E	E
S	S
W	W
ugavaq	ugavagh(N)^[Abs.Sg]
peyukegkat	peyuke(V)^@~–(g)kagh(V→N)^[Abs.Pl]
iqlighmelnguq	iqlighmete(V)^[Ptcp.Intr]^[3Sg]
qavnqaq	qavngaq(PTCL)
oavngaq	qavngaq(PTCL)
piyuglleqiinga	piyug(V)^@lleqe(V→V)^[Ptcp.Intr]^[1Sg]
piyuglleqiinga	piyug(V)^@lleqe(V→V)^[Ptcp.Intr]^[1Sg]
whangaperegwaaghmeng	whanga(PRO.AbsRel.1Sg)^–perewaagh(N→N)^[Abl_Mod.Sg]
whangkunni	whangkunni(PRO.Loc.1Pl)
Patam	Pata(N)^[Rel.Sg]
Patankuk	Pata(N)^~sf-w:(e)nku(N→N)^[Abs.Du]
Kanunkuk	Kanu(N)^~sf-w:(e)nku(N→N)^[Abs.Du]
Kanu	Kanu(N)^[Abs.Sg]
naaptaq	naaptagh(N)^[Abs.Sg]
iiksaghtughaak	iike(V)^@~fyaghtugh(V→V)^[Ind.Trns]^[3Sg.3Du]
kaasaghtughaak	kaate(V)^@~fyaghtugh(V→V)^[Ind.Trns]^[3Sg.3Du]
Tinanam	Tinana(N)^[Rel.Sg]
esghaghaak	esghagh(V)^[Ind.Trns]^[3Sg.3Du]
Ipi	Ipi(N)^[Abs.Sg]
paayghltegnekek	paayghi(V)^[Opt.Pres.Trns]^[2Du.3Du]
Ipim	Ipi(N)^[Rel.Sg]
apaminun	apa(N)^[All.4SgPoss.Sg]
Pata	Pata(N)^[Abs.Sg]
taanʼgavek	[Anaphor]^un'gavek(DEM.ADV.All)
unisnaghnaqamken	unite(V)^?^@~fnaqe(V→V)^[Ind.Trns]^[1Sg.2Sg]
Helen	Helen(N)^[Abs.Sg]
qantaghqameng	qantagh(V)^@~–(g)kagh(V→N)^[Abl_Mod.Sg]
allaghlluggaghmeng	allaghlluggaagh(N)^[Abl_Mod.Sg]
sivuklukuu	sivuke(V)^[Sbrd.Trns]^[_.3Sg]
aqmghllequq	aghmig(V)^@lleqe(V→V)^[Ind.Intr]^[3Sg]
piziin	pi(V)^[Intrg.Intr.2Sg]
suupemengllu	suupe(N)^[Abl_Mod.Sg]^=llu
kaa-a	kaa(PTCL)
aqnifqaamituq	aqnigh(V)^[Opt.Neg.Pres.Intr]^?^[Ind.Intr]^[3Sg]
neghuvangi	neghuvate(V)^[Abs.3SgPoss.Pl]
tangeghtungi	tangeghtu(V)^[Abs.3SgPoss.Pl]
tertelem	tertele(N)^[Rel.Sg]
melqwan	melqugh(N)^[Rel.3SgPoss.Sg]
awakaghaghmeggnilngughmun	awakaghagh(N)^[Loc.4PlPoss.Pl]^ete^@ngugh(V→N)^[All.Sg]
taam	taam(PTCL)
neghigatutmeggneng	negh(V)^@~:(ng)igate(V→V)^@~:(u)te(V→N)^[Abl_Mod.4PlPoss.Sg]
igleghusimakanga	igleghte(V)^@~:(i/u)ma(V→V)^[Ptcp.Trns]^[3Sg.3Sg]
uyaqghwakun	uyaqugh(N)^[Prl.3SgPoss.Sg]
taakunginaghhaagneng	taake(V)^~:(ng)u(V→V)^~:(ng)inagh*(N→N)^?^[Abl_Mod.Du]
igleghaghtaamalghii	igleghte(V)^+(s)ta(V→N)^@~:(i/u)ma(V→V)^[Ptcp.Intr]^[3Sg]
neghesimangisimalghii	neghe(V)^@~:(i/u)mangite(V→V)^@~:(i/u)ma(V→V)^[Ptcp.Intr]^[3Sg]
piniipegsan	piniqe(V)^?
tengsimakanga	tenge(V)^@~:(i/u)ma(V→V)^[Ptcp.Trns]^[3Sg.3Sg]
uyavaghpanun	uyavagh(N)^[All.Pl]
sikugnesimalghii	siku(N)^[Loc.Du]^ete^@~:(i/u)ma(V→V)^[Ptcp.Intr]^[3Sg]
aglasimakanga	aglagh(V)^@~:(i/u)ma(V→V)^[Ptcp.Trns]^[3Sg.3Sg]
pinigepiglluku	piniqe(V)^–pigte(V→V)^[Sbrd.Trns]^[_.3Sg]
kelehgakistekluku	kelengakiste(N)^~–ke(N→V)^[Sbrd.Trns]^[_.3Sg]
teghiikusam	teghikusagh(N)^[Rel.Sg]
saaghhwaakun	saaghw(AREA)^[Prl.Sg]
Unuusisukangamnguq	Unuusisukanga(N)^[Rel.Sg]=nguq
Unuusisukanganguq	Unuusisukanga(N)^[Abs.Sg]=nguq
unaangum	unaangu(V)^[Rel.Sg]
neqanganun	neqe(N)^[All.3SgPoss.Sg]
iiteklagmi	iiteklag(N)^[Loc.Sg]
pinighqusiqlu	pinighqe(V)^~:(u)sigh(V→N)^[Abs.Sg]^=llu
ighivgaam	ighivagh(V)^[Rel.Sg]
aghhutanga	aghhutanga tamaghhaan(PTCL)
kelaaset	kelaase(N)^[Abs.Pl]
iqangighsalghetlu	iqangigh(V)^+sagh(V→V)^–llegh(V→N)^[Abs.Pl]^=llu
pinighsalghetlu	pinigh(V)^+sagh(V→V)^–llegh(V→N)^[Abs.Pl]^=llu
perasaaqanka	perasa(V)~(g)aqe(V→V)^[Ind.Trns]^[1Sg.3Pl]
perasenka	peras(N)^[Abs.1SgPoss.Pl]
wiikeni	wiike(N)^[Loc.Sg]
pinighyuugtaquq	pinighyug(V)^–ghte(V→V)^~(g)aqe(V→V)^[Ind.Intr]^[3Sg]
peleghqengngiitat	peleghqe(V)^~:(ng)ite(V→V)^[Intrg.Intr]^[3Pl]
iqitngaghma	iqitngagh(POS→QUANTQUAL)^[1Sg]
hall-mi	hall(N)^[Loc.Sg]
tiiskama	?
iqitniita	iqitngagh(POS→QUANTQUAL)^[3Pl]
fire	fire(N)^[Abs.Sg]
alarma	alarm(N)^[Abs.Sg]
aqfalighaataamagha	aqfaate(V)^?
kaayteka	kaayte(N)^[Abs.1SgPoss.Sg]
electricgem	electric(N)^[Rel.Sg]
nekegneqlu	nekegte(V)^@~f–negh(V→N)^[Abs.Sg]^=llu
uteghvani	uteghvagh(V)^[Loc.Sg]
ayemrugtallu	ayemruugte(V)^[Abs.Sg]^=llu
fresh	fresh(ADJ)
iireyugaqunga	iire(N)^@~fyug(N→V)^~(g)aqe(V→V)^[Ind.Intr]^[1Sg]
aghhuta	aghhutanga tamaghhaan(PTCL)
tamaghhaani	tamaghhagh*(QUANTQUAL)^[Loc.Sg]
kiyaghtaallghit	kiyaghte(V)^?^–llegh(V→N)^[Abs.3PlPoss.Pl]
yuvghiighaqaak	yuvghiigh(V)^~(g)aqe(V→V)^[Intrg.Intr]^[3Du]
maalghuneng	maalghug(NUM)^[Abl_Mod.Pl]
qanlenguq	qanlenguq(PTCL)
tevezneq	teveznegh(N)^[Abs.Sg]
ayakmitaq	ayakmitagh(V)^[Abs.Sg]
esluq	eslugh(V)^[Abs.Sg]
saasqa	saasqagh(N)^[Abs.Sg]
paagka	?
kavuk	?
yita	yite(V)^[Abs.Sg]
kiimlluk	kiimlug(POS)^[Abs.Sg]
kiimlluk	kiimlug(POS)^[Abs.Sg]
qetngiq	qetngigh(V)^[Abs.Sg]
kalefqun	?
pugnan	?
pugnaaqegtak	pugnaate(V)^@–nqegtagh(V→N)^[Abs.Sg]
kalevneghak	kaleve(V)^@~f–negh(V→N)^[Abs.Du]
ahneghtughtekestaghaqaa	aghneghtughte(V)^–kestagh(V→V)^~(g)aqe(V→V)^[Ind.Trns]^[3Sg.3Sg]
nunivagseghag	nunivagseghagh(N)^[Abs.Sg]
anuqatuq	anuqate(V)^[Ind.Intr]^[3Sg]
tengtestaghwaaghpenasi	tenge(V)^+(te)ste(CmpdVbl)^~–(ghw/ngw/w)aagh(V→V)^@-nghite(V→V)^[Sbrd.Intr]^[2Pl]
tengtestaghwaaghpenasi	tenge(V)^+(te)ste(CmpdVbl)^~–(ghw/ngw/w)aagh(V→V)^@-nghite(V→V)^[Sbrd.Intr]^[2Pl]
tengtestaghwaaghpenasi	tenge(V)^+(te)ste(CmpdVbl)^~–(ghw/ngw/w)aagh(V→V)^@-nghite(V→V)^[Sbrd.Intr]^[2Pl]
qasuqestaq	qasugh(N)^–kestagh(V→V)^[Abs.Sg]
igiitaghaaghtaa	igiitaghagh(N)^+te(N→V)^[Ind.Trns]^[3Sg.3Sg]
igleghtengnginaamaluta	igleghte(V)^~:(ng)inagh(V→V)^@~:(i/u)ma(V→V)^[Sbrd.Trns]^[_.1Pl]
amsanaghqwaagaa	amsanagh(N)^–ghqu(N→V)^~(g)aqe(V→V)^[Ind.Trns]^[3Sg.3Sg]
puqleghaagsimaa	puqleghaagh(N)^@~:(i/u)ma(V→V)^[Ind.Trns]^[3Sg.3Sg]
puqleghaagsimaa	puqleghaagh(N)^@~:(i/u)ma(V→V)^[Ind.Trns]^[3Sg.3Sg]
thermometer-em	thermometer(N)^[Rel.Sg]
zero	zero(NUM)
degrees	degree(N)^[Abs.Pl]
qanlenguqun	qanglengugh(PTCL)^=qun
teveznegha	teveznegh(N)^[Abs.3SgPoss.Sg]
ayakmitngaaq	ayakmitagh(V)^~fnga(POS→STATIVE)^[Ind.Intr]^[3Sg]
Pertum	Pertu(N)^[Rel.Sg]
anuqalnguq	anuqate(V)^@ngugh(V→N)^[Abs.Sg]
eslumun	eslugh(V)^[All.Sg]
skiitiingemeng	skiitiinge(N)^[Abl_Mod.Sg]
tengtesnaghtuq	tenge(V)^?^[Ind.Intr]^[3Sg]
a-ay	ay(PTCL)
America-mi	America(N)^[Loc.Sg]
paagkenguuq	paagken(DEM.ADV.Abl_Mod)^~:(ng)u(N→V)^[Ind.Intr]^[3Sg]
ikevaghmeng	ikevagh(N)^[Abl_Mod.Sg]
eltughwani	eltughagh*(N)^[Abs.4SgPoss.Sg]
kavyuguutegipenateng	kavyuguute(V)^@–nghite(V→V)^[Sbrd.Intr]^[4Pl]
yitaqa	yite(V)^[Ind.Trns]^[1Sg.3Sg]
kaaslampet	kaaslampe(N)^[Abs.Pl]
qaamnnemteki	qaame(V)^[Ctmp.Trns]^[1Pl.3Pl]
nanilgughngaamta	nanilghagh(N)^~fnga(POS→STATIVE)^[1Pl]
nanilgughngaamta	nanilghagh(N)^~fnga(POS→STATIVE)^[1Pl]
kalefqutet	kalefqute(N)^[Abs.Pl]
pugnatangi	pugnaate(V)^[Abs.3SgPoss.Pl]
pugnatangi	pugnaate(V)^[Abs.3SgPoss.Pl]
asilighneghanilnguut	?^~:(ng)u(N→V)^[Ind.Intr]^[3Pl]
kisaagut	kisaate(N)^[Ind.Intr]^[3Pl]
kisaagut	kisaate(N)^[Ind.Intr]^[3Pl]
pugnaaqegllak	pugnaate(N)^~(g)aqe(V→V)^–ghllag(V→N)^[Abs.Sg]
Pertu	Pertu(N)^[Abs.Sg]
kalevneghagllak	kaleve(V)^@~f–negh(V→N)^–ghllag(N→N)^[Abs.Sg]
kavyuguutegi-penateng	kavyuguute(V)^@–nghite(V→V)^[Sbrd.Intr]^[4Pl]
awazigi	awazigh(N)^[Abs.3SgPoss.Pl]
awazigi	awazigh(N)^[Abs.3SgPoss.Pl]
Pertum	Pertu(N)^[Rel.Sg]
tagilaghaasimalghiit	tagi(V)^~f-laghate(V→V)^@~:(i/u)ma(V→V)^[Ptcp.Intr]^[3Pl]
agaghluteng	agaghte(V)^[Sbrd.Intr]^[4Pl]
uyughwani	uyughagh*(N)^[Abs.4SgPoss.Sg]
sayugwaa	sayug(V)^[Ind.Trns]^[3Sg.3Sg]
kaagtughluku	?^[Sbrd.Trns]^[_.3Sg]
eltughwani	eltughagh*(N)^[Abs.4SgPoss.Pl]
nepaghqelliit	?^[Abs.3PlPoss.Pl]
kepkaghyightut	?^[Ind.Intr]^[3Pl]
igkamsuwaa	igkamsug(V)^[Ind.Trns]^[3Sg.3Sg]
igkaghaghaa	iigkaghagh(V)^[Ind.Trns]^[3Sg.3Sg]
itemtigu	iteme(V)^[Opt.Pres.Trns.2Sg.3Sg]
ilemtigu	ileme(V)^[Opt.Pres.Trns.2Sg.3Sg]
akuwaaghtaq	akugaagh(PTCL)^+tagh(N→V)^[Abs.Sg]
akuwaaghtaq	akugaagh(PTCL)^+tagh(N→V)^[Abs.Sg]
taanangwaaquq	[Anaphor]^whaa(DEM.PRO.Abs.Sg)^~–(ghw/ngw/w)aagh(V→V)^[Ind.Intr]^[3Sg]
tugunghiighaquq	tugu(V)^?^(g)aqe(V→V)^[Ind.Intr]^[3Sg]
sufluwani	suflugagh(N)^[Loc.Pl]
igataghlequten	igatagh(V)^@lleqe(V→V)^[Ind.Intr]^[2Sg]
agaghluteng	agaghte(V)^[Sbrd.Intr]^[4Pl]
naagu	na(WH)^[Intrg.Trns]^[2Pl.3Sg]
naagu	na(WH)^[Intrg.Trns]^[2Pl.3Sg]
Pertunkunun	Pertu(N)^~sf-w:(e)nku(N→N)^[All.Sg]
nuligha	nulighh(N)^[Abs.3SgPoss.Sg]
estuwaghmi	estugagh*(N)^[Loc.Sg]
allgegbvigani	allgeghvig(N)^[Loc.3SgPoss.Sg]
akmagusiq	akmagu(V)^~:(u)sigh(V→N)^[Abs.Sg]
anʼgighluni	an'gigh(V)^[Sbrd.Intr]^[4Sg]
kiimlluguuq	kiimllug(POS)^~:(ng)u(V→V)^[Ind.Intr]^[3Sg]
kumangaghngaaghmek	kumagh(V)^~fnga(V→V)^[Conc.Intr]^[4Du]
mamleyaaghuftuq	mamleg(V)^@~fyaaghagh(V→V)^+(pete)fte(V→V)^[Ind.Intr]^[3Sg]
tuwaa	tugu(V)^[Ind.Trns]^[3Sg.3Sg]
awavaqaanlenguq	awavaqaanlenguq(PTCL)
milughnaqutnginaq	milugh(V)^@~fnaqute(V→V)^~:(ng)inagh*(N→N)^[Abs.Sg]
angalqataghagh-lluku	angalqatagh(V)^~aghte(V→V)^[Sbrd.Trns]^[_.3Sg]
mughusi-malghii	mughute(V)^@~:(i/u)ma(V→V)^@–lghii(V→N)^[Abs.Sg]
meghnalikaq	meghnaali(V)^@~–(g)kagh(V→N)^[Abs.Sg]
meraghinaaftuq	meraaghinagh(N)^~:(ng)u(N→V)^+(pete)fte(V→V)^[Ind.Intr]^[3Sg]
teghhaneng	?^[Abl_Mod.Pl]
qiighqaaghtekaq	qiighqagh(N)^–ghte(N→V)^@~–(g)kagh(V→N)^[Abs.Sg]
piitesighaam	piitesighagh(N)^[Rel.Sg]
nunivagseghaam	nunivagseghagh(N)^[Rel.Sg]
ququngaam	ququngagh(N)^[Rel.Sg]
tunganganun	tunge(N)^[All.3SgPoss.Sg]
kaatkayuk	kaate(V)^~–kayug(V→N)^[Abs.Sg]
allaaghhiinaq	allaghhiinaq(PTCL)
kiyaghtaallghem	kiyaghte(V)^?^–llegh(V→N)^[Rel.Sg]
yugwem	yug(N)^[Rel.Sg]
inglupigaghmeng	inglupigagh(N)^[Abl_Mod.Sg]
tagtalngani	tagtala(N)[Loc.3SgPoss.Sg]
ellnginaghhaalghii	ellnginagh*(QUANTQUAL)^–ghhagh*(N→N)^@–lghii(V→N)^[Abs.Sg]
aghnaghaghpaggaaghtekaq	aghnaghagh(N)^?
kaamenganeng	kaame(N)^[Abl_Mod.3SgPoss.Sg]
taakwegkutgun	[Anaphor]^ukegku(DEM.PRO)^[Prl.Pl]
anʼgiqriqluni	an'giqragh(V)^––iqe(V→V)^[Sbrd.Intr]^[4Sg]
anʼgighngaaghmi	an'gigh(V)^[Conc.Intr]^[4Sg]
sak-maa-nii-nguuq	sakmani(DEM.ADV.Loc)^~:(ng)u(N→V)^[Ind.Intr]^[3Sg]
sak-maa-nii-nguuq	sakmani(DEM.ADV.Loc)^~:(ng)u(N→V)^[Ind.Intr]^[3Sg]
iitghelten	itegh(V)^[Opt.Pres.Intr]^[1Pl]
tawavek	[Anaphor]^awavek(DEM.ADV.All)
pilaataghtughnguq	pi(V)^@~flaatagh(V→V)^+tugh(V→V)^@ngugh(V→N)^[Abs.Sg]
maatenllaam	maaten(PTCL)^?^[Rel.Sg]
avelghaghaak	avelghagh(V)^[Ind.Trns]^[3Sg.3Du]
tespikapighqaaghluku	tespikapighqaagh(V)^[Sbrd.Trns]^[_.3Sg]
sak-paa-tii-kuuq	sakmani(DEM.ADV.Loc)^~:(ng)u(N→V)^[Ind.Intr]^[3Sg]
sakpa	sakma(DEM.ADV)
utaaq	?
ii-maa	iime(V)^[Ind.Trns]^[3Sg.3Sg]
ii-paa	iime(V)^[Ind.Trns]^[3Sg.3Sg]
aghulaquu-si-maat	aghulaqe(V)^~(q/t)uute(V→V)^@~:(i/u)ma(V→V)^[Ind.Intr]^[3Pl]
aghulaquu-si-paat	aghulaqe(V)^~(q/t)uute(V→V)^@~:(i/u)ma(V→V)^[Ind.Intr]^[3Pl]
iitgheltet	itegh(V)^[Opt.Pres.Intr]^[1Pl]
peqsaghtaa	meqsaghtugh(V)^[Opt.Pres.Intr.2Sg]
iitqaghutkelluku	itegh(V)^~–qagh(V→V)^@~:(u)tke(V→V)^[Sbrd.Trns]^[_.3Sg]
tutemqaghqameng	tutemqagh(N)^+kagh(N→N)^[Abl_Mod.Sg]
tespikna	[Anaphor]^piikna(DEM.PRO.Abs.Sg)
taanangutanga	[Anaphor]^whaa(DEM.PRO.Abs.Sg)^~:(ng)u(N→V)^@~:(u)te(V→N)^[Abs.3SgPoss.Sg]
akuziighaatalghii	akuzi(V)^+aghaghte(V→V)^[Ptcp.Intr]^[3Sg]
tugwaa	tugu(V)^[Ind.Trns]^[3Sg.3Sg]
naagu	na(WH)^[Intrg.Trns]^[2Pl.3Sg]
naagu	na(WH)^[Intrg.Trns]^[2Pl.3Sg]
taananguftuq	[Anaphor]^whaa(DEM.PRO.Abs.Sg)^~:(ng)u(N→V)^+(pete)fte(V→V)^[Ind.Intr]^[3Sg]
aliinghakuun	aliinegh(N)^[Prl.3SgPoss.Sg]
amsanaakuun	amsanagh(N)^[Prl.3SgPoss.Sg]
kenlengitgun	kelenga(V)^[Prl.3PlPoss.Sg]
tamaagaa	tamaa(V)^[Ind.Trns]^[3Sg.3Sg]
teghiis-tek	neghigh(V)^~:(ng)u(V→V)^+(s)ta(V→N)^[Abs.Pl]
asitum	asi(AREA)^[All.Sg]
aya-ya-luuk	aya-ya-luuk(XCLM)
ku-uu-iiya	ku-uu-iiya(XCLM)
qghuugh	qghuugh(XCLM)
aay	aay(PTCL)
ataasighhaghmeng	ataasigh(NUM)^–ghhagh*(N→N)^[Abl_Mod.Sg]
estugwenkami	estug(N)^[Abs.1SgPoss.Pl]^=mi
taakwagun	[Anaphor]^ukagun(DEM.ADV.Prl)
agigngalghiignekun	agigte(V)^~fnga(V→V)^@–lghii(V→N)^[Prl.Du]
alii-luuy-ngen	aliiluyngen(PTCL)
aliiluyngen	aliiluyngen(PTCL)
elaayngen	elaayngen(PTCL)
sinang-awen	sinang-awen(PTCL)
ku-uuy	kuuy(PTCL)
u-uuy	u-uuy(PTCL)
quq	quq(PTCL)
meteghllugwem	meteghllug(N)^[Rel.Sg]
iighhwnnaqaanga	iighwte(V)^@~fnaqe(V→V)^[Ind.Trns]^[3Sg.1Sg]
sayugwaa	sayug(V)^[Ind.Trns]^[3Sg.3Sg]
ufsughqutaqluni	ufsulqutagh(V)^[Sbrd.Intr]^[4Sg]
nagun	na(WH)^[Prl.Sg]
ayguqliignekun	aygughqligh*(N)^[Prl.Du]
elpegmi	elpeni(PRO.Loc.2Sg)
mallaaghhaanun	mallagh(N)^–ghhagh*(N→N)^[All.3SgPoss.Sg]
eslumun	eslugh(V)^[All.Sg]
ifkamalghii	ifkagh(V)^@~:(i/u)ma(V→V)^[Ptcp.Intr]^[3Sg]
taam	taam(PTCL)
tuqaaghesnaq	tuqu(V)^~f(a)ghesnagh(V→V)^[Abs.Sg]
nguugraghaak	nguugragh(V)^[Ind.Trns]^[3Sg.3Du]
neghaak	neghe(V)^[Ind.Trns]^[3Sg.3Du]
tunughllaguftughnguq	tunugh(N)^–ghllag(N→N)^~:(ng)u(N→V)^+(pete)fte(V→V)^+tugh(N→V)^[Ptcp.Intr]^[3Sg]
saaghhwaakun	saaghw(N)^[Prl.3SgPoss.Sg]
naanlluni	?^[Sbrd.Intr]^[4Sg]
arekulngamnguq	arekull(PTCL)^=ngam^=nguq
paamnangakun	paamna(DEM.PRO.Abs.Sg)^[Prl.3SgPoss.Sg]
arekulngam	arekull(PTCL)^=ngam
tengugwenka	tengug(N)^[Abs.1SgPoss.Pl]
aangwllaasinka	aangwaagh(V)^?^[Abs.1SgPoss.Pl]
huk	huk(PTCL)
tulimiikun	tulimagh(N)^[Prl.Sg]
kalngagalleghqwaaq	kalngagagh(N)^–llegh(V→N)+kwaagh(N→N)^[Abs.Sg]
melqumsuwhiighusimakanga	melqugh(N)^–msuggagh*(N→N)^@~:(u)te(V→N)^@~:(i/u)ma(V→V)^[Ptcp.Trns]^[3Sg.3Sg]
melqumsuwhiighusimakanga	melqugh(N)^–msuggagh*(N→N)^@~:(u)te(V→N)^@~:(i/u)ma(V→V)^[Ptcp.Trns]^[3Sg.3Sg]
naangtengngwaaghluku	naangngwaaghagh(V)^[Sbrd.Trns]^[_.3Sg]
pugnaaqutkennanighsiki	pugnaaqute(N)^@~:(u)tke(V→V)^@~fnanigh(V→V)^[Intrg.Trns]^[2Sg.3Pl]
suflughragmeng	suflugh(N)^+raag(N→N)^[Abl_Mod.Sg]
teghhumaaqelghiinga	?^@~:(i/u)ma(V→V)^~(g)aqe(V→V)^@–lghii(V→N)^[Abs.3SgPoss.Sg]
teghhumasiqa	?^@~:(i/u)ma(V→V)^~:(u)sigh(V→N)^[Abs.1SgPoss.Sg]
tungtulugwem	tungtu(N)^–lug(N→N)^[Rel.Sg]
puqlaaqutet	puqlate(V)^~(g)aqe(V→V)^@~:(u)te(V→N)^[Rel.Pl]
suupeghlaguuq	suupe(V)^–ghllagu(V→V)^[Ind.Intr]^[3Sg]
iniighet	?^[Abs.Pl]
anuqatuq	anuqate(V)^[Ind.Intr]^[3Sg]
tawatetuq	tawate(V)^[Ind.Intr]^[3Sg]
Kiiluq	Kiilugh(N)^[Abs.Sg]
agghiyugneghllak	agghiyugniqe(V)^–ghllag(V→N)^[Abs.Sg]
nallutghaaghlluku	nallutghagh(V)^[Sbrd.Trns]^[_.3Sg]
aghuliighnaqenghata	aghuliigh(V)^@~fnaqe(V→V)^[Ctmp.Intr]^[3Pl]
piniighqwaamakanga	pinighqagh(N)^~:(ng)u(N→V)^@~:(i/u)ma(V→V)^[Ptcp.Trns]^[3Sg.3Sg]
piniighqwaamakanga	pinighqagh(N)^~:(ng)u(N→V)^@~:(i/u)ma(V→V)^[Ptcp.Trns]^[3Sg.3Sg]
aangeghngaata	aange(V)^[Conc.Intr]^[3Pl]
aapsat	?
aataqaaput	aate(V)^~(g)aqe(V→V)^[Ind.Trns]^[1Pl.3Sg]
aflengakuraaqsaghqaaluki	aflengakuraagh(V)^@~fyaghqagh(V→N)^[Sbrd.Trns]^[_.3Pl]
aghqesqughhaq	aghqe(N)^–squghhagh*(N→N)^[Abs.Sg]
aglanqigtutuq	aglagh(V)^@–nqigte(V→V)^[Ind.Intr]^[3Sg]
aklumaghngaamta	akluma(V)^[Conc.Intr]^[1Pl]
akulangani	akula(N)^[Loc.3SgPoss.Sg]
akulangitgun	akula(N)^[Prl.3PlPoss.Sg]
alirugwakegllaget	?^–ghllag(N→N)^[Abs.Pl]
allaaghhiinaat	allaghhiinagh(PTCL)^[Abs.Pl]
allaaghhiinaat	allaghhiinagh(PTCL)^[Abs.Pl]
allaaghhiinaawaqut	allaghhiinagh(PTCL)^~(g)aqe(V→V)^[Ind.Intr]^[3Pl]
allaaghhiinaawaqut	allaghhiinagh(PTCL)^~(g)aqe(V→V)^[Ind.Intr]^[3Pl]
allaaghhiinaghmeng	allaghhiinagh(PTCL)^[Abl_Mod.Sg]
allaaghhiinaghmeng	allaghhiinagh(PTCL)^[Abl_Mod.Sg]
allaaghhiinaq	allaghhiinaq(PTCL)
allaaghlluwhaat	allaaghlluggagh*(N)^[Abs.Pl]
alliighaqaaqukut	allighagh(V)^@~–(g)kaqe(V→V)^[Ind.Intr]^[1Pl]
alliighaqaaqukut	allighagh(V)^@~–(g)kaqe(V→V)^[Ind.Intr]^[1Pl]
alliighighaqukut	allighagh(N)^––igh(N→V)^~(g)aqe(V→V)^[Ind.Intr]^[1Pl]
amsanaam	amsanagh(V)^[Rel.Sg]
aqlaghakegllak	aqlagha(N)^~–ke(N→V)^–ghllag(V→N)^[Abs.Sg]
aqupileghsaghaatkegkek	aqupileghsagh(V)^@~:(u)tke(V→V)^@~–(g)ke(V→N)^[Abs.Du]
army-t	army(N)^[Abs.Pl]
ataataka	ataata(N)^[Abs.1SgPoss.Sg]
ataatama	ataata(N)^[Rel.1SgPoss.Sg]
ataatamaallu	ataata(N)^[Rel.1SgPoss.Sg]^=llu
ataatamaallu	ataata(N)^[Rel.1SgPoss.Sg]^=llu
ataatamta	ataata(N)^[Rel.1PlPoss.Sg]
ataatavut	ataata(N)^[Abs.1PlPoss.Sg]
ataatavutlu	ataata(N)^[Abs.1PlPoss.Sg]^=llu
atkugwi	atkug(N)^[Abs.3SgPoss.Pl]
atkuyaangllaghteghaqiinkut	atkuyaagh(N)^–ngllagh(N→V)^@~:(u)te(V→V)^~(g)aqe(V→V)^[Ind.Trns]^[3Sg.1Pl]
atkuyaangllaghteghaqiinkut	atkuyaagh(N)^–ngllagh(N→V)^@~:(u)te(V→V)^~(g)aqe(V→V)^[Ind.Trns]^[3Sg.1Pl]
avlaawaatam	avlawa(N)^+tagh(N→N)^[Rel.Sg]
avlaawaatam	avlawa(N)^+tagh(N→N)^[Rel.Sg]
avlaawakun	avlawa(N)^[Prl.Sg]
ayugwinnaqepiglluki	ayugite(V)^@~fnaqe(V→V)^?^[Sbrd.Trns]^[_.3Pl]
ayumiqunneghani	ayumiqun(PTCL)^[Ctmp.Intr]^[3Sg]
ayuqeftaak	ayuqe(V)^+(pete)fte(V→V)^[Ind.Trns]^[3Sg.3Du]
boiler-et	boiler(N)^[Abs.Pl]
box-ngan	box(N)^[Rel.3SgPoss.Sg]
by	by(PREP)
can-em	can(N)^[Rel.Sg]
candle-ek	candle(N)^[Abs.Du]
candy-meng	candy(N)^[Abl_Mod.Sg]
cards-engaqelghii	card(N)^[Pl]^e(YUPIKALIZER)^?^~(g)aqe(V→V)^[Ptcp.Intr]^[3Sg]
cards-ngi	card(N)^[Pl]^[Abs.3SgPoss.Pl]
catalog-eni	catalog(N)^[Loc.Sg]
ceiling-efut	ceiling(N)^e(YUPIKALIZER)^[Abs.1PlPoss.Sg]
ceiling-efut	ceiling(N)^e(YUPIKALIZER)^[Abs.1PlPoss.Sg]
Claus-allu	Santa Claus(N)^e(YUPIKALIZER)^=llu
Claus-em	Santa Clause(N)^[Rel.Sg]
coffee	coffee(N)
color-et	color(N)^[Abs.Pl]
compass-esqughhaaklu	compass(N)^e(YUPIKALIZER)^–squghhagh*(N→N)^[Abs.Sg]^=llu
crepe	crepe(N)^[Abs.Sg]
cross-em	cross(N)^[Rel.Sg]
cross-et	cross(N)^[Abs.Pl]
ellngitallu	ellngit(PRO.Abs.3Pl)^=llu
enkaangam	enkaamngam(PTCL)
esghanemteki	esghagh(V)^[Ctmp.Trns]^[1Pl.3Pl]
esleqaqaghput	esleqe(V)^[Ind.Trns]^[1Pl.3Pl]
esneghrugwi	esneghrug(N)^[Abs.3SgPoss.Pl]
esnelaaghusighluteng	esnelaaghute(V)^~:(u)sigh(V→N)^[Sbrd.Intr]^[3Pl]
estaamaneng	estaamat(NUM)^[Abl_Mod.Sg]
family-nga	family(N)^[Abs.3SgPoss.Sg]
feet	foot(N)^[Abs.Pl]
feet-ngnguuq	foot(N)^~:(ng)u(N→V)^[Ind.Intr]^[3Sg]
feet-ngnguuq	foot(N)^~:(ng)u(N→V)^[Ind.Intr]^[3Sg]
gas	gas(N)^[Abs.Sg]
generator-esqughhaak	generator(N)^e(YUPIKALIZER)^–squghhagh*(N→N)^[Abs.Du]
guard-et	guard(N)^[Abs.Pl]
handkerchief-et	handkerchief(N)^[Abs.Pl]
heater-meng	heater(N)^[Abl_Mod.Sg]
igaghrakegtellghan	igagh(V)^@~f–rakegte(V→V)^–llegh(V→N)^[Rel.3SgPoss.Sg]
ightughqennayukaata	ightugh(V)^+qe(V→V)^@~fnayuke(V→V)^[Cond.Intr]^[3Pl]
ightughqennayukaata	ightugh(V)^+qe(V→V)^@~fnayuke(V→V)^[Cond.Intr]^[3Pl]
iimgutangllaannemteggu	imeg(V)^@~:(u)te(V→V)^-ngllagh(V→V)^[Ctmp.Trns]^[1Pl.3Sg]
iimgutangllaannemteggu	imeg(V)^@~:(u)te(V→V)^-ngllagh(V→V)^[Ctmp.Trns]^[1Pl.3Sg]
iimgutfiikughyaqmegtegnegu	imeg(V)^@~:(u)te(V→V)^@~fvike(V→V)^?^[Prl.4DuPoss.Sg]
iimgutkayugwet	imeg(V)^@~:(u)te(V→V)^~-kayug(V→N)^[Abs.Pl]
ilaagaamaamta	ilagagh(V)^@~:(i/u)magh*(V→QUANTQUAL)^[1Pl]
ilaakwaaput	ilakwaagh(N)^[Abs.1PlPoss.Pl]
ingavelqiinaqlu	ingavek(DEM.ADV.All)^–lqiinagh(V→V)^[Abs.Sg]^=llu
ingavelqiinaqlu	ingavek(DEM.ADV.All)^–lqiinagh(V→V)^[Abs.Sg]^=llu
ipegsaasit	ipegsaate(N)^[Abs.3PlPoss.Pl]
ivaghileghtaagaqukut	ivagh(V)^?^~(g)aqe(V→V)^[Ind.Intr]^[1Pl]
iyaqraasiqumaagkenka	iyagh(V)^–qragh(V→V)^~:(u)sigh(V→N)^@~:(i/u)ma(V→N)^[Rel.3SgPoss.Du]
iyaqraasiqumaagkenka	iyagh(V)^–qragh(V→V)^~:(u)sigh(V→N)^@~:(i/u)ma(V→N)^[Rel.3SgPoss.Du]
iyaqughaaqii	iyagh(V)^@qugh(V→V)^~(g)aqe(V→V)^[Ind.Trns]^[3Sg.3Pl]
iyaqughaaqii	iyagh(V)^@qugh(V→V)^~(g)aqe(V→V)^[Ind.Trns]^[3Sg.3Pl]
jacks-etlu	jacks(N)^[Abs.Pl]^=llu
jeans-engit	jeans(N)^e(YUPIKALIZER)^[Abs.3PlPoss.Pl]
kagpagtughaqaghput	kagpag(V)^+tugh(V→V)^~(g)aqe(V→V)^[Ind.Trns]^[1Pl.3Sg]
kanaghfikughaqaput	kanaghte(V)^@~fvike(V→V)^?^~(g)aqe(V→V)^[Ind.Trns]^[1Pl.3Sg]
kanaghfikumakanginkut	kanaghte(V)^@~fvike(V→V)^@~:(i/u)ma(V→V)^[Ptcp.Trns]^[3Sg.1Pl]
kaviighsiighumaqelghiillu	kaviigh(N)^+siigh(N→V)^@~:(i/u)ma(V→V)^~(g)aqe(V→V)^@–lghii(V→N)^[Abs.Sg]^=llu
kerosene	kerosene(N)^[Abs.Sg]
kinghaagaghluteng	kinegh(V)^?^[Sbrd.Intr]^[3Pl]
kumaghsugllagngaamteki	kumaghugh(V)^–ghllag(V→V)^[Conc.Trns]^[1Pl.3Pl]
kumaghsugllagngaamteki	kumaghugh(V)^–ghllag(V→V)^[Conc.Trns]^[1Pl.3Pl]
Kuusmelleghput	Kuusme(N)^–llegh(V→N)^[Abs.1PlPoss.Sg]
Kuusmenaqem	Kuusme(N)^@~fnaqe(V→N)^[Rel.Sg]
Kuusmesugnighllutek	Kuusme(N)^+sugnite(V→V)^[Sbrd.Intr]^[4Du]
Kuusmesugnighllutek	Kuusme(N)^+sugnite(V→V)^[Sbrd.Intr]^[4Du]
Kuusmesugnightaaqaa	Kuusme(N)^+sugnite(V→V)^~(g)aqe(V→V)^[Ind.Trns]^[3Sg.3Sg]
Kuusmesugnightaaqaa	Kuusme(N)^+sugnite(V→V)^~(g)aqe(V→V)^[Ind.Trns]^[3Sg.3Sg]
Kuusmeyaq	Kuusmeyagh(V)^[Abs.Sg]
lamp-pem	lamp(N)^[Rel.Sg]
legreyugwem	legre(V)^@~fyug(V→V)^[Rel.Sg]
llilaghtughaaput	llilagh(V)^+tugh(V→V)^[Ind.Trns]^[1Pl.3Sg]
makequnnemta	makete(V)^@qugh(V→V)^[Ctmp.Intr]^[1Pl]
makequnnemta	makete(V)^@qugh(V→V)^[Ctmp.Intr]^[1Pl]
mattress-em	mattress(N)^[Abs.Sg]
mattress-nganeng	mattress(N)^[Abl_Mod.3SgPoss.Sg]
meghnum	megh(N)^[All.Sg]
mekesqughhaayaghtuq	meke(N)^–squghhagh*(N→N)^@~fyagh(N→V)^[Ind.Intr]^[3Sg]
melqighaghmeng	melqiighagh(N)^[Abl_Mod.Sg]
melqighaghmeng	melqiighagh(N)^[Abl_Mod.Sg]
mesunat	mesuuna(N)^[Abs.Sg]
mission	mission(N)^[Abs.Sg]
mission-em	mission(N)^[Rel.Sg]
muff-emeng	muff(N)^e(YUPIKALIZER)^[Abl_Mod.Sg]
naagu	na(WH)^[Intrg.Trns]^[2Pl.3Sg]
naagu	na(WH)^[Intrg.Trns]^[2Pl.3Sg]
naghaghutet	naghaagh(V)^@~:(u)te(V→N)^[Abs.Pl]
naligkenka	naligh(WH)^[Rel.3SgPoss.Du]
naliighhiinaghput	naligh(WH)^~:(ng)inagh*(N→N)^[Abs.1PlPoss.Pl]
naliighhiinaghput	naligh(WH)^~:(ng)inagh*(N→N)^[Abs.1PlPoss.Pl]
nasaperaaghitlu	nasaperagh(N)^[Abs.3PlPoss.Pl]^=llu
nasaperaaghitlu	nasaperagh(N)^[Abs.3PlPoss.Pl]^=llu
national	national(ADJ)
needle-ngi	needle(N)^[Abs.3SgPoss.Sg]
nunaatughqwaagaa	?
nusugraghteghaqaput	nusug(V)^?^~(g)aqe(V→V)^[Ind.Trns]^[1Pl.3Pl]
nutaaghameng	nutaghagh(N)^[Abl_Mod.Sg]
nutaghaghllugwaaqut	nutaghagh(N)^+llug(N→N)^~:(ng)u(N→V)^~(g)aqe(V→V)^[Ind.Intr]^[3Pl]
nutemkaghtameng	nutem(PTCL)^+kaghtagh(DEM→N)^[Abl_Mod.Sg]
nuugtesnemteki	nuug(V)^+(te)ste(CmpdVbl)^[Ctmp.Trns]^[1Pl.3Pl]
ornament-et	ornament(N)^[Abs.Pl]
paper-meng	paper(N)^[Abl_Mod.Sg]
petugteghumiita	petugutagh(V)^?
pikengluteng	pikenge(V)^[Sbrd.Intr]^[3Pl]
pikengyalghiikut	pikenge(V)^[PtcpObl.Intr]^[1Pl]
pine	pine(ADJ)
pinighyuugtestellgha	pinigh(V)^@~fyug(V→V)^+(te)ste(CmpdVbl)^–llegh(V→N)^[Abs.3SgPoss.Sg]
piraamsineghllak	piraamsi(V)^@~f–negh(V→N)^–ghllag(N→N)^[Abs.Sg]
piyaanneqegsaataqut	piyaa(V)^@–nqegsagh(V→V)^@~:(u)te(V→V)^~(g)aqe(V→V)^[Ind.Intr]^[3Pl]
praasentaa	praasentaa(V)^[Abs.Sg]
praasentaa	praasentaa(V)^[Abs.Sg]
praasentaaqanka	praasentaa(V)^~(g)aqe(V→V)^[Ind.Trns]^[1Sg.3Pl]
praasentaasiput	praasentaasigh(N)^[Abs.1PlPoss.Pl]
praasentaasiq	praasentaasigh(N)^[Abs.Sg]
praasentaasiwaqut	praasentaasigh(N)^~(g)aqe(V→V)^[Ind.Intr]^[3Sg]
praasentaasiwaqut	praasentaasigh(N)^~(g)aqe(V→V)^[Ind.Intr]^[3Sg]
praasentalaghaaqaput	praasenta(V)^~f–laghate(V→V)^~(g)aqe(V→V)^[Ind.Trns]^[1Pl.3Sg]
praasentalaghaaqaput	praasenta(V)^~f–laghate(V→V)^~(g)aqe(V→V)^[Ind.Trns]^[1Pl.3Sg]
praasentasighqiitneng	praasentasigh(N)^?^[Abl_Mod.Pl]
praasentasimeng	praasentaasigh(N)^[Abl_Mod.Sg]
praasentasimun	praasentaasigh(N)^[All.Sg]
praasentasiput	praasentaasigh(N)^[Abs.1PlPoss.Pl]
praasentasiqneghmeng	praasentaasigh(N)^@~f–negh(V→N)^[Abl_Mod.Sg]
praasentasit	praasentaasigh(N)^[Abs.Pl]
praasentataqukut	praasentaa(V)^~(g)aqe(V→V)^[Ind.Intr]^[1Pl]
prasentaasit	praasentaasigh(N)^[Abs.Pl]
program-eneghmeng	program(V)^e(YUPIKALIZER)^@~f–negh(V→N)^[Abl_Mod.Sg]
qaamggunginaq	qamagunginaq(PTCL)
qaamngaamta	qaamna(DEM.PRO.Abs.Sg)^~fnga(POS→STATIVE)^[1Pl]
qaanngwaateng	qaanngwaagheg(N)^[Abs.Pl]
qafsin'gulluku	qafsineg(WH)^~:(ng)u(N→V)^[Sbrd.Trns]^[_.3Sg]
qagaavek	qagavek(DEM.ADV.All)
qamanlluki	qamani(DEM.ADV.Loc)^[Sbrd.Trns]^[_.3Pl]
qaspiqunneghilnguut	qaspighte(V)^@–nghite(V→V)^@ngugh(V→N)^[Abs.Pl]
qayutighluta	qayutigh(V)^[Sbrd.Intr]^[1Pl]
qelaaneghnaghllak	qelaate(V)^@~f–negh(V→N)^–ghllag(N→N)^[Abs.Sg]
qelanqennemteggu	qelanqe(V)^[Ctmp.Trns]^[1Pl.3Sg]
qelanqennemteggu	qelanqe(V)^[Ctmp.Trns]^[1Pl.3Sg]
qelanqesagutaaqaghput	qelanqe(V)^@~fyagute(V→V)^@~–(g)kagh(V→N)^[Abs.1PlPoss.Sg]
qeleghtengnguunaamta	qelegh(V)^?^~:(ng)ite(V→V)^[Sbrd.Trns]^[_.1Pl]
qemtamesalghii	qemtagh(N)^?^@–lghii(V→N)^[Abs.Sg]
qerngaaghhaamta	qerngagh(V)^[Conc.Intr]^[1Pl]
qerngughutaqaput	qerngagh(V)^@~:(u)te(V→V)^~(g)aqe(V→V)^[Ind.Trns]^[1Pl.3Pl]
qiipaghameng	qiipaghagh*(N)^[Abl_Mod.Sg]
qikeghqungigalnguq	qikeghte(V)^–qu(V→V)^@~:(ng)igate(V→V)^@ngugh(V→N)^[Abs.Sg]
qipellegaghteghaqii	qipellegagh(N)^?^~(g)aqe(V→V)^[Ind.Trns]^[3Sg.3Pl]
qugwintapayugwek	qugintagh(V)^?^[Abs.Du]
quilt-et	quilt(N)^[Abs.Pl]
qulliiraaghmengllu	qulliraagheg(N)^[Abl_Mod.Sg]^=llu
red	red(ADJ)
room-engiighhaq	room(N)^e(YUPIKALIZER)^?^–ghhagh*(N→N)^[Abs.Sg]
ruler-et	ruler(N)^[Abs.Pl]
saghnaagha	saghnaagha(N)^[Abs.Sg]
saghnaaghaneng	saghnaagha(N)^[Abl_Mod.Pl]
saghnaaghmeng	saghnaagha(N)^[Abl_Mod.Sg]
salngaawaasqughhaat	salngawrag(N)^–squghhagh*(N→N)^[Abs.Pl]
salngaawrii	salngawrag(N)^[Abs.3SgPoss.Pl]
salngaawrii	salngawrag(N)^[Abs.3SgPoss.Pl]
seghleqesisigalkeput	seghleqe(V)^+(te)sigate(CmpdVbl)^[Ptcp.Trns]^[1Pl.3Pl]
sigiiqellghem	sigiqe(V)^–llegh(V→N)^[Rel.Sg]
sivutghulluku	sivutghute(V)^[Sbrd.Trns]^[_.3Sg]
skate-telghiit	skate(V)^@~:(u)te(V→N)^@–lghii(V→N)^[Abs.Pl]
skate-tetaqut	skate(V)^?^~(g)aqe(V→V)^[Ind.Intr]^[3Pl]
skate-tiingelghiit	skate(V)^[PROG]^e(YUPIKALIZER)^[Ptcp.Intr]^[3Pl]
skate-tiingellghiit	skate(V)^[PROG]^e(YUPIKALIZER)^[Ptcp.Intr]^[3Pl]
snowman-allu	snowman(N)^e(YUPIKALIZER)^=llu
suflugwii	suflugagh(N)^[Abs.3SgPoss.Pl]
suit-em	suit(N)^[Rel.Sg]
sumeghtaghaatkennemkun	sumeghtaghagh(V)^@~:(u)tke(V→V)^[Ctmp.Trns]^[1Sg.3Sg]
sumeghtaghaatkennemkun	sumeghtaghagh(V)^@~:(u)tke(V→V)^[Ctmp.Trns]^[1Sg.3Sg]
taananguuq	[Anaphor]^whaa(DEM.PRO.Abs.Sg)^~:(ng)u(V→V)^[Ind.Intr]^[3Sg]
taaqenghaata	taaqe(V)^[Ctmp.Intr]^[3Pl]
table-eni	table(N)^e(YUPIKALIZER)^[Abs.Du]
tamaakunguut	?^~:(ng)u(V→V)^[Ind.Intr]^[3Pl]
tamaanlengughmeng	?^[Abl_Mod.Sg]
tamaatum	?
tamaghhaanun	tamaghhagh*(QUANTQUAL)^[All.Sg]
tapghaghpawaaghmeng	tapghaaghagh(N)^[Abl_Mod.Sg]
tawaatelnguq	tawatete(V)^@ngugh(V→N)^[Abs.Sg]
tawaaten	[Anaphor]^whaa(DEM.ADV.Equ)
tawaateteghngiita	tawatete(V)^[Conc.Intr]^[3Pl]
tawaavek	[Anaphor]^awavek(DEM.ADV.All)
teghiglugwem	teghiglug(N)^[Rel.Sg]
turn-kaghtaamta	turn(N)^+kaghtagh(DEM→N)^[Rel.1PlPoss.Sg]
turn-kaghtaamta	turn(N)^+kaghtagh(DEM→N)^[Rel.1PlPoss.Sg]
tuugtekayugwet	tuugte(V)^~–kayug(V→N)^[Rel.Pl]
uglaghllagwaaqelghii	uglagh(N)^–ghllag(N→N)^~:(ng)u(N→V)^~(g)aqe(V→V)^[Ptcp.Intr]^[3Sg]
ugwatangaghmiit	?
uliimaamnneng	ulima(V)^[Abl_Mod.1PlPoss.Sg]
uliimaamnneng	ulima(V)^[Abl_Mod.1PlPoss.Sg]
ulimaaqaghput	ulima(V)^@~–(g)kagh(V→N)^[Abs.1PlPoss.Sg]
ulimaaqaghput	ulima(V)^@~–(g)kagh(V→N)^[Abs.1PlPoss.Sg]
ulimalaghteghaqaput	ulima(V)^?^~(g)aqe(V→V)^[Ind.Trns]^[1Pl.3Sg]
umyugwamkun	umyugagh(N)^[Prl.1SgPoss.Sg]
unanguluku	unaangu(V)^[Sbrd.Trns]^[_.3Sg]
unangupiglluku	unaangu(V)^–pigte(V→V)^[Sbrd.Trns]^[_.3Sg]
uqfiglluwhaq	uqfillegagh(N)^[Abs.Sg]
uqfiillegaaghhaq	uqfillegagh(N)^–ghhagh*(N→N)^[Abs.Sg]
uqfiillegaaghhaq	uqfillegagh(N)^–ghhagh*(N→N)^[Abs.Sg]
usilukeklu	usiligh(V)^[Abs.3SgPoss.Du]^=llu
usilukeklu	usiligh(V)^[Abs.3SgPoss.Du]^=llu
usputaasiqumaagkenka	usputagh(V)^~:(u)sigh(V→N)^@~:(i/u)ma(V→N)^[Rel.3SgPoss.Du]
uumkayugwet	umeg(V)^~–kayug(V→N)^[Abs.Pl]
uygiinaghmeng	uygiinghagh*^[Abl_Mod.Sg]
whangamni	whangamni(PRO.Loc.1Sg)
whangkunneng	whangkunneng(PRO.Abl_Mod.1Pl)
whangkunni	whangkunni(PRO.Loc.1Pl)
whanikunghaani	whanikun(PTCL)^[Ctmp.Intr]^[3Sg]
yimiyumteggun	yimi(EMO)^@~f–yu(V→N)^[Prl.1PlPoss.Sg]
yo-yo-ngllanemta	yo-yo(N)^–ngllagh(N→V)^[Ctmp.Intr]^[1Pl]
yughaghvimtaallu	yughaghvig(N)^+tagh(N→N)^[Abs.3SgPoss.Sg]^=llu
yugmekaghtat	?^[Abs.Pl]
zipper-elwaaqluteng	zipper(N)^e(YUPIKALIZER)^–lgu(N→V)^~(g)aqe(V→V)^[Sbrd.Intr]^[4Pl]
esghaaqaalutek	esghaate(V)^~–qagh(V→V)^[Sbrd.Intr]^[4Du]
estelwaaqluteng	esteg(N)^–lgu(N→V)^~(g)aqe(V→V)^[Sbrd.Intr]^[4Pl]
ighaleqetaalwaaqut	ighaleqetaagh(N)^–lgu(N→V)^~(g)aqe(V→V)^[Ind.Intr]^[3Pl]
nagtuqalwaaqluteng	nagtuqagh(N)^–lgu(N→V)^~(g)aqe(V→V)^[Sbrd.Intr]^[4Pl]
neqelwaaqukut	neqe(N)^–lgu(N→V)^~(g)aqe(V→V)^[Ind.Intr]^[1Pl]
qafsinʼgulluku	qafsineg(WH)^~:(ng)u(N→V)^[Sbrd.Trns]^[_.3Sg]
qamiyngakun	qamiye(N)^[Prl.3SgPoss.Sg]
piyukenghinneghmegteki	piyuke(V)^@–nghite(V→V)^[Ctmp.Trns]^[4Pl.3Pl]
tuunyunghinneghmegteki	tuune(V)^@~f–yu(V→V)^@–nghite(V→V)^[Ctmp.Trns]^[4Pl.3Pl]
tuunyunghinniiqiit	tuune(V)^@~fyug(V→V)^@-nghite(V→V)^@~fniigh(V→V)^@~–(g)kagh(V→N)^[Abs.3PlPoss.Pl]
ighsaakaa	ighsake(V)^[Ind.Trns]^[3Sg.3Sg]
g-g-g	g-g-g(XCLM)
kevgaqumakanga	kevgaagh(V)^@~:(i/u)ma(V→V)^[Ptcp.Trns]^[3Sg.3Sg]
iquklighpigaghnun	iquklighpigagh(N)^[All.Pl]
aghnangllaghyaamalghii	aghnangllagh(V)^@~fyagh(V→V)^@~:(i/u)ma(V→V)^[Ptcp.Intr]^[3Sg]
qamaay	qama(DEM.ADV)^[Voc.Sg]
sivugllaataghtuq	sivuke(V)^@~flaatagh(V→V)^[Ind.Intr]^[3Sg]
tawatengwaaghwaaq	tawaten(PTCL)^~–(ghw/ngw/w)aagh(V→V)^~–(ghw/ngw/w)aagh(V→V)^[Abs.Sg]
anaguleghtesleqaghpenga	anaguleghte(V)^?^[Conc.Trns]^[2Sg.1Sg]
anaguleghlleqamken	anaguleghte(V)^@lleqe(V→V)^[Ind.Trns]^[1Sg.2Sg]
yugnguq	yug(N)^[Abs.Sg]^=nguq
esghaaghaa	esghagh(V)^[Ind.Trns]^[3Sg.3Sg]
yugwem	yug(N)^[Rel.Sg]
piziin	pi(V)^[Intrg.Intr.2Sg]
ugwiineghmeng	ugiigh(V)^@~f–negh(V→N)^[Rel.4PlPoss.Sg]
tawavek	[Anaphor]^awavek(DEM.ADV.All)
ugwikaghqani	ugi(N)^~–kaghqagh(N→N)^[Loc.Pl]
piniighqwaamakanga	pinighqagh(N)^~:(ng)u(N→V)^@~:(i/u)ma(V→V)^[Ptcp.Trns]^[3Sg.3Sg]
nighuwhalek	nighugh(V)^~sf–ghhaleg(V→XCLM)
tungangani	tunge(N)^[Loc.3SgPoss.Sg]
miinglutanga	miinglute(N)^[Abs.3SgPoss.Sg]
ilepghaaq	ilepghaagheg(N)^[Abs.Sg]
kapesegaq	kapesegag(N)^[Abs.Sg]
tungangan	tunge(N)^[Rel.3SgPoss.Sg]
taakwavek	[Anaphor]^ukavek(DEM.ADV.All)
ugwikaghqaminun	ugi(N)^~–kaghqagh(N→N)^[All.4SgPoss.Sg]
tehem	tehem(XCLM)
mataghquumakangi	mataghqe(V)^@~:(i/u)ma(V→V)^[Ptcp.Trns]^[3Sg.3Pl]
kapesegaamalghii	kapesegag(N)^@~:(i/u)ma(V→V)^[Ptcp.Intr]^[3Sg]
ugwikullghiik	ugi(N)^~–ke(N→V)^@~:(u)te(V→V)^[Ptcp.Intr]^[3Du]
sagneghpaget	sagnegh(N)^+pag(V→V)^[Abs.Pl]
iteghaasata	itegh(V)^[Ctmp.Intr]^[3Pl]
qalmamineng	?^[Abl_Mod.4SgPoss.Sg]
sagneghpagem	sagnegh(N)^+pag(V→V)^[Rel.Sg]
qaneghmiquumakangi	qaneghmiqe(V)^@~:(i/u)ma(V→V)^[Ptcp.Trns]^[3Sg.3Pl]
sakiminun	saki(N)^[All.4SgPoss.Sg]
neghesimakek	neghe(V)^@~:(i/u)ma(V→N)^[Abs.3SgPoss.Du]
tutmaghwaaghyaamalghiit	tutmaghwaagh(V)^@~fyagh(N→V)^@~:(i/u)ma(V→V)^[Ptcp.Intr]^[3Pl]
taagaveqaaghaq	[Anaphor]^aga(DEM.ADV)^?
tutmaghwaanqusiin	tutmaghwaagh(V)^?^[Intrg.Intr.2Sg]
Tawavek	[Anaphor]^awavek(DEM.ADV.All)
Iistumii	Iistumii(N)^[Abs.Sg]
Qugtuqaghtuurughmii	Qugtuqaghtuurughmii(N)^[Abs.Sg]
Aghveghtughmii	Aghveghtughmii(N)^[Abs.Sg]
tallimaat	tallimat(NUM)
Ullungagtuuru	Ullungagtuuru(N)^[Abs.Sg]
tawanlluki	[Anaphor]^whaa(DEM.ADV.Loc)^[Sbrd.Trns]^[_.3Pl]
siqlugwaq	siqlugagh(N)^[Abs.Sg]
ugwinga	ugi(N)^[Abs.3SgPoss.Sg]
Iistumiim	Isistumii(N)^[Rel.Sg]
siqlugwaghqu	siqlugaghqu(V)^[Opt.Pres.Intr.2Sg]
ugwingan	ugi(N)^[Rel.3SgPoss.Sg]
siqlugwani	siqlugagh(N)^[Loc.Pl]
ugwini	ugi(N)^[Abs.4SgPoss.Sg]
aay	aay(PTCL)
uqesqaghhaghma	?
Iistumiinkut	Iistumii(N)^~sf-w:(e)nku(N→N)^[Abs.Pl]
Aghveghtughmiinkut	Aghveghtughmii(N)^~sf-w:(e)nku(N→N)^[Abs.Pl]
Ullungagtuurunkut	Ullungagtuuru(N)^~sf-w:(e)nku(N→N)^[Abs.Pl]
naangsimiit	naange(V)^?
qeteghaghtuq	qetegh(POS)^~aghte(V→V)^[Ind.Intr]^[3Sg]
maketengngaay	makete(V)^[Opt.Pres.Trns]^[2Pl.1Sg]^[Voc.Sg]
maketengngaay	makete(V)^[Opt.Pres.Trns]^[2Pl.1Sg]^[Voc.Sg]
ngaay	ngaay(XCLM)
taawanlengughnguq	tawanlenguq(PTCL)=nguq
ugwatangani	uga(DEM.ADV)^+ta(DEM→N)^[Loc.3SgPoss.Sg]
taam	taam(PTCL)
Qughrughaam	Qughrughagh(N)^[Rel.Sg]
Kuyapegrugaaghem	Kuyapergrugaagh(N)^[Rel.Sg]
esghapaghngaaghmigu	esghapag(V)^[Conc.Trns]^[4Sg.3Sg]
piniqaaghtaa	piniqe(V)^~aghte(V→V)^[Ind.Trns]^[3Sg.3Sg]
aqumesimakanga	aqume(V)^@~:(i/u)ma(V→V)^[Ptcp.Trns]^[3Sg.3Sg]
naantulngi	?^[Abs.3SgPoss.Pl]
natetulngi	?^[Abs.3SgPoss.Pl]
saaqutngi	?^[Abs.3SgPoss.Pl]
Qiitaq	Qiitagh(N)^[Abs.Sg]
Willu	Willu(N)^[Abs.Sg]
Willum	Willu(N)^[Rel.Sg]
ugwini	ugini(N)^[Abs.Sg]
Ggutlumun	Ggutlu(N)^[All.Sg]
yugwet	yug(N)^[Abs.Pl]
suugwerngeneng	suugernge(N)^[Abl_Mod.Pl]
suugwerngeneng	suugernge(N)^[Abl_Mod.Pl]
Qiitaam	Qiitagh(N)^[Rel.Sg]
Ggutlunkunun	Ggutlu(N)^~sf-w:(e)nku(N→N)^[All.Sg]
Ggutlunkut	Ggutlu(N)^~sf-w:(e)nku(N→N)^[Abs.Pl]
oven-kun	oven(N)^[Prl.Sg]
neqekrangllaghpagni	neqekrangllagh(N)^+pag(V→V)^+ni(N→N)^[Abs.Sg]
Qiitaankut	Qiitagh(N)^~sf-w:(e)nku(N→N)^[Abs.Pl]
eslakliq	eslaqligh*(N)^[Abs.Sg]
Qiitaankuk	Qiitagh(N)^~sf-w:(e)nku(N→N)^[Abs.Du]
suugwerngengiteftuq	suugernge(N)^~:(ng)ite(N→V)^+(pete)fte(V→V)^[Ind.Intr]^[3Sg]
qaamnangat	qaamna(DEM.PRO.Abs.Sg)^[Abs.3PlPoss.Sg]
oven-elgek	oven(N)^e(YUPIKALIZER)^–leg(N→N)^[Abs.Du]
coffee-ngllaasiqlu	coffee(N)^–ngllagh(N→V)^~:(u)sigh(V→N)^[Abs.Sg]^=llu
coffee-ngllaasiqlu	coffee(N)^–ngllagh(N→V)^~:(u)sigh(V→N)^[Abs.Sg]^=llu
qayuliisiqlu	qayugh(N)^–ligh(N→V)^~:(u)sigh(V→N)^[Abs.Sg]^=llu
table-ek	table(N)^[Abs.Du]
keniimaagkenka	kenigh(V)^@~:(i/u)ma(V→N)^[Rel.3SgPoss.Du]
ggutangi	ggute(N)^[Abs.3SgPoss.Pl]
natungwaa	natu(WH)^~:(ng)u(N→V)^[Intrg.Intr]^[3Sg]
natungwaa	natu(WH)^~:(ng)u(N→V)^[Intrg.Intr]^[3Sg]
Siimiiyaq	Siimiiyagh(N)^[Abs.Sg]
gguutniighusini	ggute(N)^@~fniigh(N→V)^~:(u)sigh(V→N)^[Loc.Pl]
gguutniighusini	ggute(N)^@~fniigh(N→V)^~:(u)sigh(V→N)^[Loc.Pl]
tazingkuk	[Anaphor]^inga(DEM.ADV)^~sf-w:(e)nku(N→N)^[Abs.Du]
igarutaaghsugningiighhiilnguuk	igarutaagh(N)^+sugnite(N→V)^?^@–nghite(V→V)^@ngugh(V→N)^[Abs.Du]
Siimiiyaam	Siimiiyagh(N)^[Rel.Sg]
tukeghraghaak	tukeghragh(V)^[Ind.Trns]^[3Sg.3Du]
tzzzz	tzzzz(XCLM)
kaapusimeng	kaape(V)^~:(u)sigh(V→N)^[Abl_Mod.Sg]
quneghqumaghmi	qunegh(POS)^–qu(V→V)^@~:(i/u)magh*(V→QUANTQUAL)^[4Sg]
iflaasaghaa	ifla(V)^+sagh(V→V)^[Ind.Trns]^[3Sg.3Sg]
maateqwaqun	maateqwaakun(PTCL)
aqnighhneghiitaa	aqnighte(V)^@–nghite(V→V)^[Ind.Trns]^[3Sg.3Sg]
umughqwaangalghii	umughqaa(V)^~fnga(V→V)^[Ptcp.Intr]^[3Sg]
paper	paper(N)^[Abs.Sg]
sack-a	sack(N)^[Abs.Sg]
Satankuk	Sata(N)^~sf-w:(e)nku(N→N)^[Abs.Du]
naghaaq	naghaagh(V)^[Abs.Sg]
pinighyuugtuq	pinighyug(V)^[Ind.Intr]^[3Sg]
puqlalnguq	puqlate(V)^@ngugh(V→N)^[Abs.Sg]
suupeliighpagni	suupeliigh(N)^+pag(V→V)^+ni(N→N)^[Abs.Sg]
suupeliightuusighqameng	suupeliigh(N)^?^@~–(g)kagh(V→N)^[Abl_Mod.Sg]
library-meng	library(N)^[Abl_Mod.Sg]
nayaaggaa	nayag(N)^–ghhagh*(N→N)^[Abs.3SgPoss.Sg]
taghnughhaghwaghmeng	taghnughhagh*(N)^–ghhagh*(N→N)^[Abl_Mod.Sg]
magazine-melngughmeng	magazine(N)^[Loc.Sg]^ete^@ngugh(V→N)^[Abl_Mod.Sg]
table-legni	table(N)^–leg(N→N)^[Loc.Pl]
apaay	apa(N)^[Voc.Sg]
nagasugwaqegkangat	nagate(V)^@~fyug(V→V)^~(g)aqe(V→V)^[Ptcp.Trns]^[3Pl.3Sg]
akuzikayugwet	akuzi(V)^~–kayug(V→N)^[Abs.Pl]
unʼganlengughmeng	un'ganlengugh(N)^[Abl_Mod.Sg]
sumeghtaghamalghii	sumeghtaghagh(V)^@~:(i/u)ma(V→V)^[Ptcp.Intr]^[3Sg]
sumeghtaghaatkengnginaghngaaghmigu	sumeghtaghagh(V)^@~:(u)tke(V→V)^~:(ng)inagh(V→V)^[Conc.Trns]^[4Sg.3Sg]
angqaperukguutuk	angqaperug(N)^+uute(N→V)^[Ind.Intr]^[3Du]
qamagtengngwaaghluni	qamagte(V)^~–(ghw/ngw/w)aagh(V→V)^[Sbrd.Intr]^[4Sg]
sikullghitkayuk	siku(V)^–llghite(V→V)^~–kayug(V→N)^[Abs.Sg]
yusengetaghhaam	yusengetagh(N)^-ghhagh*(N→N)^[Rel.Sg]
mamleghqwaagaqegkanga	mamleg(V)^~–(ghw/ngw/w)aagh(V→V)^~(g)aqe(V→V)^[Ptcp.Trns]^[3Sg.3Sg]
mamleghqwaagaqegkanga	mamleg(V)^~–(ghw/ngw/w)aagh(V→V)^~(g)aqe(V→V)^[Ptcp.Trns]^[3Sg.3Sg]
negayulqalgusnaqaqegkanga	negayulqa(?)^–lgute(V→V)^@~fnaqe(V→V)^~(g)aqe(V→V)^[Ptcp.Trns]^[3Sg.3Sg]
negayulqiighunneghani	negayulqa(?)^~:(ng)i:ghute(N→V)^[Ctmp.Intr]^[3Sg]
yusengetaghhaq	yusengetagh(N)^-ghhagh*(N→N)^[Abs.Sg]
esnevapagllafqaami	esnevagh(V)^–pagllag(V→V)^[Opt.Neg.Pres.Intr]^[Loc.Sg]
samengam	sameng(WH)^=ngam
uunghameng	uunghagh*(N)^[Abl_Mod.Sg]
jacket-tet	jacket(N)^[Abs.Pl]
qillghuquulluki	?^[Sbrd.Trns]^[_.3Pl]
sayugusighqaaluki	sayug(V)^~:(u)sigh(V→N)^?^[Sbrd.Trns]^[_.3Pl]
tawavek	[Anaphor]^awavek(DEM.ADV.All)
nusugwaghhnaqsaghqaalghiit	nusug(V)^~aghte(V→V)^@~fnaqe(V→V)^@~fyaghqagh(V→N)^~:(ng)u(N→V)^@–lghii(V→N)^[Rel.Pl]
isekinami	isekinagh(V)^[Loc.Sg]
yugwet	yug(N)^[Abs.Pl]
negayulqameng	negayulqa(?)^[Abl_Mod.Sg]
yusengetaamesunghitunga	yusengetagh(N)^?^@–nghite(V→V)^[Ind.Intr]^[1Sg]
seghleghataghaaguq	seghlegh(N)^~(at)aghagh(V→V)^[Ind.Intr]^[3Sg]
yakughnaghataghtuq	yakugh(EMO)^?^[Ind.Intr]^[3Sg]
qamagtengngwaaghluni	qamagte(V)^~–(ghw/ngw/w)aagh(V→V)^[Sbrd.Intr]^[4Sg]
iiwem	iiw(V)^[Rel.Sg]
tungyuum	tungyugh(N)^[Rel.Sg]
puughtisighqaghtughllagtuq	puughte(V)^~:(u)sigh(V→N)^~-kaghte(N→V)^-ghllag(V→V)^[Ind.Intr]^[3Sg]
puughtisighqaghtughllagtuq	puughte(V)^~:(u)sigh(V→N)^~-kaghte(N→V)^-ghllag(V→V)^[Ind.Intr]^[3Sg]
nangllagraketun	?^[Equ.3SgPoss.Du]
uughsaghqaq	uughhe(V)^+sagh(V→V)^@~–(g)kagh(V→N)^[Abs.Sg]
esnaghniifqaami	esnagh(N)^@~fniite(V→V)^[Opt.Neg.Pres.Intr]^[Loc.Sg]
taanangiinaanghituq	[Anaphor]^whaa(DEM.PRO.Abs.Sg)^~:(ng)inagh(V→V)^@–nghite(V→V)^[Ind.Intr]^[3Sg]
taanangiinaanghituq	[Anaphor]^whaa(DEM.PRO.Abs.Sg)^~:(ng)inagh(V→V)^@–nghite(V→V)^[Ind.Intr]^[3Sg]
iiggwtesneghminigu	iiw(V)^+(te)ste(CmpdVbl)^[Ctmp.Trns]^[4Sg.3Sg]
uusqaghqwaagaqaa	uusqagh(V)^~–(ghw/ngw/w)aagh(V→V)^~(g)aqe(V→V)^[Ind.Trns]^[3Sg]
uusqaghqwaagaqaa	uusqagh(V)^~–(ghw/ngw/w)aagh(V→V)^~(g)aqe(V→V)^[Ind.Trns]^[3Sg]
esneveqestiightesnanighaqiit	?^+(te)snanigh(CmpdVbl)^~(g)aqe(V→V)^[Ind.Trns]^[3Pl.3Pl]
yusengetaamengllu	yusengetagh(N)^[Abl_Mod.Sg]^=llu
ingaghsaghtughtegngam	ingagh(POS)^+saghtugh(V→V)^?
goodnight	goodnight(PTCL)
qavanguqenghillangi	qavangugh(V)^@–nghite(V→V)^?
meghnum	megh(N)^[All.Pl]
qavamalghii	qavagh(V)^@~:(i/u)ma(V→V)^[Ptcp.Intr]^[3Sg]
ellmaaraghqwaamakanga	ellmaaragte(V)^~–(ghw/ngw/w)aagh(V→V)^@~:(i/u)ma(V→V)^[Ptcp.Trns]^[3Sg.3Sg]
ellmaaraghqwaamakanga	ellmaaragte(V)^~–(ghw/ngw/w)aagh(V→V)^@~:(i/u)ma(V→V)^[Ptcp.Trns]^[3Sg.3Sg]
ellmaaraghqwaamakanga	ellmaaragte(V)^~–(ghw/ngw/w)aagh(V→V)^@~:(i/u)ma(V→V)^[Ptcp.Trns]^[3Sg.3Sg]
igleghutkelluku	igleghte(V)^@~:(u)tke(V→V)^[Sbrd.Trns]^[_.3Sg]
nagallaaghpenani	?^@–nghite(V→V)^[Sbrd.Intr]^[4Sg]
riisaaghnaqnimakangi	riisaagh(N)^@~fnaqe(V→V)^@~:(i/u)ma(V→N)^[Ptcp.Trns]^[3Sg.3Pl]
Kaspiklu	Kaspig(N)^[Abs.Sg]^=llu
saltine	saltine(N)
cracker-et	cracket(N)^[Abs.Pl]
awavanlleghpigaannaqusimalghiit	awavagh(V)^-lleghpigagh(V→N)^~:(ng)u(N→V)^@~fnaqute(V→V)^@~:(i/u)ma(V→V)^[Ptcp.Intr]^[3Pl]
haak	haak(XCLM)
uughhiinkuut	uughhe(V)^[Ind.Trns]^[3Sg.1Pl]
araaghaataasimalghiit	araghaatagh(V)^@~:(i/u)ma(V→V)^[Ptcp.Intr]^[3Pl]
araaghaataasimalghiit	araghaatagh(V)^@~:(i/u)ma(V→V)^[Ptcp.Intr]^[3Pl]
uughhiinkuu-ut	uughhe(V)^[Ind.Trns]^[3Sg.1Pl]
yugwem	yug(N)^[Rel.Sg]
nagaqumakangi	nagaqugh(V)^@~:(i/u)ma(V→V)^[Ptcp.Trns]^[3Sg.3Pl]
dory-meng	dory(N)^[Abl_Mod.Sg]
ivenrumeng	ivenruute(N)^[Abl_Mod.Sg]
ellmeggneng	ellmeggneng(PRO.Abl_Mod.4Pl)
nalighhiinaat	naligh(WH)^~:(ng)inagh*(N→N)^[Abs.Pl]
nalighhiinaat	naligh(WH)^~:(ng)inagh*(N→N)^[Abs.Pl]
aghsughwaaluteng	aghsugh(V)^~–(ghw/ngw/w)aagh(V→V)^[Sbrd.Intr]^[4Pl]
nunmaasquvegaghhaq	nunmaaw(V)^–sluvegagh(N→N)^–ghhagh*(N→N)^[Abs.Sg]
nunmaasquvegaghhaq	nunmaaw(V)^–sluvegagh(N→N)^–ghhagh*(N→N)^[Abs.Sg]
taananginaghhaq	[Anaphor]^whaa(DEM.PRO.Abs.Sg)^~:(ng)inagh*(N→N)^–ghhagh*(N→N)^[Abs.Pl]
meteghllugwem	meteghllug(N)^[Rel.Sg]
ellngani	ellngani(PRO.Loc.3Sg)
nalughqaghsimalghii	nalug(V)^~–qaghte(V→V)^@~:(i/u)ma(V→V)^[Ptcp.Intr]^[3Sg]
tawanlenguq	tawanlenguq(PTCL)
meteghlluuy	meteghllug(N)^[Voc.Sg]
aghulaaqsiin	aghula(V)^~(g)aqe(V→V)^[Intrg.Intr.2Sg]
quyaaghaghteghrugumaghmi	quya(V)^+aghaghte(V→V)^–ghrug(V→V)^@~:(i/u)magh*(V→QUANTQUAL)^[4Sg]
qung	qung(PTCL)
qughlung	qunglung(PTCL)
quneghtepallaghqaaghluten	qunegh(POS)^+te(POS→ACTIVE)^?^[Sbrd.Intr]^[2Sg]
avleghtepallaghqaaghluten	avlegh(POS)^+te(POS→ACTIVE)^?^[Sbrd.Intr]^[2Sg]
quneghqennallgha	qunegh(POS)^?^–llegh(V→N)^[Abs.3SgPoss.Sg]
quunghaghsimalghii	qunegh(POS)^~aghte(V→V)^@~:(i/u)ma(V→V)^[Ptcp.Intr]^[3Sg]
quneghqelluni	qunegh(POS)^+qe(V→V)^[Sbrd.Intr]^[4Sg]
quulvaghaghteghruneghminigu	quulvagh(V)^~aghte(V→V)^–ghrug(V→V)^[Ctmp.Trns]^[4Sg.3Sg]
paagguqaghaq	?
sukanghhaghmitun	sukate(V)^@–nghhagh(V→N)^[Equ.4SgPoss.Sg]
taam	taam(PTCL)
paapgiinaa	papeg(N)^~:(ng)i:ghute(N→V)^?
akuqamakanga	akuqagh(V)^@~:(i/u)ma(V→V)^[Ptcp.Trns]^[3Sg.3Sg]
ngillegrugsimaghmi	ngillegte(V)^–ghrug(V→V)^@~:(i/u)magh*(V→QUANTQUAL)^[4Sg]
ngillegrugsimaghmi	ngillegte(V)^–ghrug(V→V)^@~:(i/u)magh*(V→QUANTQUAL)^[4Sg]
ngillegrugsimaghmi	ngillegte(V)^–ghrug(V→V)^@~:(i/u)magh*(V→QUANTQUAL)^[4Sg]
iilqumalghi	iilqe(V)^@~:(i/u)ma(V→V)^[Ptcp.Intr]^[3Sg]
paapgiinniluni	papeg(N)^~:(ng)i:ghute(N→V)^@~fni(CmpdVbl)^[Sbrd.Intr]^[4Sg]
natungam	natu(WH)^=ngam
natungam	natu(WH)^=ngam
naveghlleqaqa	navegh(V)^@lleqe(V→V)^[Ind.Trns]^[1Sg.3Sg]
sikigaghaq	sikigaghagh(N)^[Abs.Sg]
naveghlleqaanguq	navegh(V)^@lleqe(V→V)^[Ind.Trns]^[3Sg.3Sg]^=nguq
kiimsitanganeng	kiimsitagh(V)^[Abl_Mod.3SgPoss.Sg]
sikigaghaam	sikigaghagh(N)^[Rel.Sg]
pilataamalghii	pi(V)^@~flaatagh(V→V)^@~:(i/u)ma(V→V)^[Ptcp.Intr]^[3Sg]
ungipanneqigsaghtughhu	ungipaate(V)^@–nqigte(V→V)^+saghtugh(V→V)^[Opt.Pres.Trns.2Sg.3Sg]
waakepanghillataghtuq	waakenghillghaghte(V)^[Ind.Intr]^[3Sg]
ungipasimakanga	ungipaate(V)^@~:(i/u)ma(V→V)^[Ptcp.Trns]^[3Sg.3Sg]
ungipasaghtughhu	ungipaate(V)^+saghtugh(V→V)^[Opt.Pres.Trns.2Sg.3Sg]
maatenllaam	maaten(PTCL)^?^[Rel.Sg]
neqnighrakegtameng	neqnigh(V)^@~f–rakegtagh(V→N)^[Abl_Mod.Sg]
naveghhnaaghniluku	navegh(V)^@~fnaagh(V→V)^@~fni(CmpdVbl)^[Sbrd.Trns]^[_.3Sg]
paapgaq	papeg(N)^[Abs.3SgPoss.Sg]
meteghllukrugwem	meteghllug(N)^–qrug(N→N)^[Rel.Sg]
naveghhnaanghitaa	navegh(V)^@~fnaagh(V→V)^@–nghite(V→V)^[Ind.Trns]^[3Sg.3Sg]
yugwem	yug(N)^[Rel.Sg]
tamanameng	[Anaphor]^maana(DEM.PRO.Abs.Sg)^[Abl_Mod.Sg]
naveghtesnaayaghaqa	navegh(V)^+(te)ste(CmpdVbl)^@~fnayagh(V→V)^[Ind.Trns]^[1Sg.3Sg]
naveghtesnaayaghaqa	navegh(V)^+(te)ste(CmpdVbl)^@~fnayagh(V→V)^[Ind.Trns]^[1Sg.3Sg]
naveghlleqniluku	navegh(V)^@lleqe(V→V)^@~fni(CmpdVbl)^[Sbrd.Trns]^[_.3Sg]
iilqamiqngwaaghluni	iilqe(V)^@~fmiqe(CmpdVbl)^~–(ghw/ngw/w)aagh(V→V)^[Sbrd.Intr]^[4Sg]
pikengnaqsinga	?^@~fnaqe(V→V)^[Intrg.Intr]^[1Sg]
sumeghtaghaatkengngiinaq	sumeghtaghagh(V)^@~:(u)tke(V→V)^~:(ng)inagh(N→N)^[Abs.Sg]
emaay	emaay(VOC)
mekestaghhaghmeng	mekestaaghhagh*(N)^[Abl_Mod.Sg]
ayuqesugnilngughmeng	ayuqe(V)^+sugnite(V→V)^@ngugh(V→N)^[Abl_Mod.Sg]
puughhnayanghisteggu	puughhe(V)^@~fnayagh(V→V)^@–nghite(V→V)^[Intrg.Trns]^[1Pl.3Sg]
aqeftaghaghhani	aqeftaghaagh(N)^–ghhagh*(N→N)^[Abs.4SgPoss.Sg]
kevgaqlaataamakanga	kevgaagh(V)^@~flaatagh(V→V)^@~:(i/u)ma(V→V)^[Ptcp.Trns]^[3Sg.3Sg]
kaatqaghutkelluku	kaate(V)^~–qagh(V→V)^@~:(u)tke(V→V)^[Sbrd.Trns]^[_.3Sg]
efqughqwaamakanga	efqugh(EMO)^~–(ghw/ngw/w)aagh(V→V)^[Ptcp.Trns]^[3Sg.3Sg]
efqughqwaamakanga	efqugh(EMO)^~–(ghw/ngw/w)aagh(V→V)^[Ptcp.Trns]^[3Sg.3Sg]
kgwugg	kgwugg(XCLM)
tamakenta	?
neghyugwaqelghiinga	negh(V)^@~fyug(V→V)^~(g)aqe(V→V)^[Ptcp.Intr]^[1Sg]
akuqwaamaan	akuqagh(V)^~–(ghw/ngw/w)aagh(V→V)^@~:(i/u)magh*(V→QUANTQUAL)^[3Sg]
akuqwaamaan	akuqagh(V)^~–(ghw/ngw/w)aagh(V→V)^@~:(i/u)magh*(V→QUANTQUAL)^[3Sg]
sikigaghaghmun	sikigaghagh(N)^[All.Sg]
quyaapiglluni	quya(V)^?^[Sbrd.Intr]^[4Sg]
aqeftaghaghhaq	aqeftaghaagh(N)^–ghhagh*(N→N)^[Abs.Sg]
ullghitaperegwaaghtesimakanga	ullghitagh(V)^–perewaagh(V→N)^+(te)ste(CmpdVbl)^@~:(i/u)ma(V→V)^[Ptcp.Trns]^[3Sg.3Sg]
neqnighyugwem	neqnigh(V)^@~fyug(V→V)^[Rel.Sg]
neqnighyugwem	neqnigh(V)^@~fyug(V→V)^[Rel.Sg]
kangruguteghllagumalghii	?^–ghllag(V→V)^@~:(i/u)ma(V→V)^[Ptcp.Intr]^[3Sg]
C-R-U-U-U-N-C-H	C-R-U-U-U-N-C-H
meteghllugrugwem	meteghllug(N)^–ghrug(N→N)^[Rel.Sg]
angtalnganeng	angtala(N)^[Abl_Mod.3SgPoss.Sg]
nalugumakestaamaluku	nalug(V)^@~:(i/u)ma(V→V)^–kestagh(V→V)^@~:(i/u)ma(V→V)^[Sbrd.Trns]^[_.3Sg]
meteghllugwem	meteghllug(N)^[Rel.Sg]
anipaay	anipa(N)^[Voc.Sg]
naagu	na(WH)^[Intrg.Trns]^[2Pl.3Sg]
naagu	na(WH)^[Intrg.Trns]^[2Pl.3Sg]
qghwaaghwq	qghwaaghwq(PTCL)
ii	ii(PTCL)
akiingqwaghtaghii	akiingqwaghte(V)^?
uqitaqestaghngaan	?^–kestagh(V→V)^[Conc.Intr]^[3Sg]
neqekumaaqelghiit	neqe(N)^?^@~:(i/u)ma(V→V)^~(g)aqe(V→V)^[Ptcp.Intr]^[3Pl]
kinangutanga	kina(WH.Abs.Sg)^~:(ng)u(V→V)^@~:(u)te(V→V)^[Intrg.Trns]^[3Sg.1Sg]
naaminun	naa(N)^[All.4SgPoss.Sg]
upagughnaqaghput	upag(V)^?^@~fnaqe(V→V)^?
yugwem	yug(N)^[Rel.Sg]
ugwimineng	ugi(N)^[Abl_Mod.4SgPoss.Sg]
ugwinga	ugi(N)^[Abs.3SgPoss.Sg]
mughutaneng	mughu(V)^+(s)ta(V→N)^[Abl_Mod.Pl]
naagu	na(WH)^[Intrg.Trns]^[2Pl.3Sg]
naagu	na(WH)^[Intrg.Trns]^[2Pl.3Sg]
aghsigallghan	?^–llegh(V→N)^[Loc.3SgPoss.Sg]
tunganganun	tunge(N)^[All.3SgPoss.Sg]
alngunagan	alngunak(PTCL)^[All.3SgPoss.Sg]
ellnginaghhaghmi	ellnginagh*^–ghhagh*(N→N)^[Loc.Sg]
mekelengestaghhaq	?^–ngestagh(N→N)^–ghhagh*(N→N)^[Abs.Sg]
nighuwhaq	nighuwhagh(N)^[Abs.Sg]
akamkegtalghii	akamkegtagh(N)^@–lghii(V→N)^[Abs.Sg]
ighaleqetaaghsugnitalghii	ighaleqetaagh(N)^+sugnite(N→V)^@–lghii(V→N)^[Abs.Sg]
nighuwhaghmun	nighuwhagh(N)^[All.Sg]
nighuugsimanginaamakanga	nighughte(V)^@~:(i/u)ma(V→V)^~:(ng)inagh(V→V)^@~:(i/u)ma(V→V)^[Ptcp.Trns]^[3Sg.3Sg]
qavaghaqi	qavagh(V)^~(g)aqe(V→V)^[Ind.Trns]^[3Sg.3Pl]
taghtughaqegkuvek	taghtugh(V)^~(g)aqe(V→V)^[Cond.Intr]^[2Sg]
esghaghaqegkufki	esghagh(V)^~(g)aqe(V→V)^[Cond.Trns]^[2Sg.3Pl]
aglaghaqi	aglagh(V)^~(g)aqe(V→V)^[Ind.Trns]^[3Sg.3Pl]
qaygeqlitkuvek	qaygeghte(V)^?^[Cond.Intr]^[2Sg]
silugwa	silug(N)^[Abs.3SgPoss.Sg]
llaaghanam	llaaghan(PTCL)^[Rel.Sg]
yugwi	yug(N)^[Abs.3SgPoss.Pl]
yugwita	yug(N)^[Rel.3DuPoss.Sg]
qetgeghaghluteng	qetgegh(V)^?^[Sbrd.Intr]^[4Pl]
nayyghamun	naayghagh(N)^[All.Sg]
neghesimakangat	neghe(V)^@~:(i/u)ma(V→V)^[Ptcp.Trns]^[3Pl.3Sg]
yuwhaghnguq	yuwhagh(N)^[Abs.Sg]^=nguq
unangupiglluku	unaangu(V)^–pigte(V→V)^[Sbrd.Trns]^[_.3Sg]
esnighqwataamalghii	esnighqwagh(V)^@~:(i/u)ma(V→V)^[Ptcp.Intr]^[3Sg]
qalghilqwaaghaghaqelghii	qalghigh(V)^~–qaghaqe(V→V)^~(g)aqe(V→V)^[Ptcp.Intr]^[3Sg]
qalghilqwaaghaghaqelghii	qalghigh(V)^~–qaghaqe(V→V)^~(g)aqe(V→V)^[Ptcp.Intr]^[3Sg]
aqnighqwaaluni	aqnighqe(V)^?^[Sbrd.Intr]^[3Sg]
tawatestaghhinaq	tawatestaghhiinaq(PTCL)
yuwhaam	yughagh(N)^[Rel.Sg]
naantulnga	?
itegaghhiini	itegagh(N)^?
mulaqumaluku	mulaagh(V)^–qu(V→V)^@~:(i/u)ma(V→V)^[Sbrd.Trns]^[_.3Sg]
tawavek	[Anaphor]^awavek(DEM.ADV.All)
utaaqaa	utaqa(V)^[Ind.Trns]^[3Sg.3Sg]
yataaghqengngwaaghluni	yataaghqe(V)^~–(ghw/ngw/w)aagh(V→V)^[Sbrd.Intr]^[4Sg]
quyam	quya(V)^[Rel.Sg]
yugwem	yug(N)^[Rel.Sg]
yuwhaq	yuwhagh(N)^[Abs.Sg]
sukaaghtaa	suka(N)^–ghte(N→V)^[Ind.Trns]^[3Sg.3Sg]
maateqwaaqun	maateqwaaqun(PTCL)
quyaalaataghtuq	quya(V)^@~flaatagh(V→V)^[Ind.Intr]^[3Sg]
akileghtumakanga	akileghtugh(V)^@~:(i/u)ma(V→V)^[Ptcp.Trns]^[3Sg.3Sg]
sukaghimeng	sukaghi(V)^[Abl_Mod.Sg]
May-mi	May(N)^[Loc.Sg]
June-mi	June(N)^[Loc.Sg]
taakwani	[Anaphor]^ukani(DEM.ADV.Loc)
enkaangam	enkaamngam(PTCL)
ighnilaghaataqut	ighni(V)^~f–laghate(V→V)^~(g)aqe(V→V)^[Ind.Intr]^[3Pl]
June-nem	June(N)^[Rel.Sg]
piitquunneghani	piite(V)^~(q/t)uute(V→V)^[Ctmp.Intr]^[3Sg]
imightuutaqht	imigh(V)^~(q/t)uute(V→V)^~(g)aqe(V→V)^[Ind.Trns]^[3Pl.3Pl]
ququngaghmeng	ququngagh(N)^[Abl_Mod.Sg]
nunivaataghqameng	nunivag(N)^atagh(N→N)^+kagh(N→N)^[Abl_Mod.Sg]
melqwi	melqugh(N)^[Abs.3SgPoss.Pl]
qamaninganilluki	qamani(DEM.ADV.Loc)^[Loc.3SgPoss.Sg]^[Sbrd.Intr]^[3Pl]
iiggaghhillu	iiggagh(N)^–ghhagh*(N→N)^[Abs.3SgPoss.Pl]^=llu
nuughnaqenghata	nuugh(V)^@~fnaqe(V→V)^[Ctmp.Intr]^[3Pl]
teptaaqeluki	teptaaqe(V)^[Sbrd.Trns]^[_.3Pl]
siqluwam	siqlugagh(N)^[Rel.Sg]
uksutestaqiit	uksugh(V)^+(te)ste(CmpdVbl)^~(g)aqe(V→V)^[Ind.Trns]^[3Pl.3Pl]
aqlaghalighanun	aqlagha(N)^–llegh(V→N)^[All.3SgPoss.Sg]
aqlaghalighanun	aqlagha(N)^–llegh(V→N)^[All.3SgPoss.Sg]
unangenghata	unange(V)^[Ctmp.Intr]^[3Pl]
yuges	yug(N)^[Abs.Pl]
quugkameng	quug(N)^+kagh(N→N)^[Abl_Mod.Sg]
quugkaaluki	quug(N)^+kagh(N→N)^~:(ng)u(N→V)^[Sbrd.Trns]^[_.3Pl]
neqesghaghqaq	neqesghagh(N)+kagh(N→N)^[Abs.Sg]
ngelqaaghaghmeng	ngelqagh(N)^–ghhagh*(N→N)^[Abl_Mod.Sg]
leghlleghes	leghllegh(N)^[Abs.Pl]
ngelqaaghaat	ngelqagh(N)^–ghhagh*(N→N)^[Abs.Pl]
neqekaghqat	neqe(N)^~–kaghqagh(N→N)^[Abs.Pl]
neqekaghqaaluki	neqe(N)^~–kaghqagh(N→N)^~:(ng)u(N→V)^[Sbrd.Trns]^[_.3Pl]
holiday-neghagu	holiday(V)^[Ctmp.Trns]^[3Sg.3Sg]
holiday-luteng	holiday(V)^[Sbrd.Intr]^[4Pl]
aghveghniighyaataqut	aghvegh(N)^@~fniigh(N→V)^@~fyaghtugh(V→V)^@~:(u)te(V→V)^~(g)aqe(V→V)^[Ind.Intr]^[3Pl]
qamagtengngwaaghluni	qamagte(V)^~–(ghw/ngw/w)aagh(V→V)^[Sbrd.Intr]^[4Sg]
pilagyaataquq	pilag(V)^@~fyaghtugh(V→V)^@~:(u)te(V→V)^~(g)aqe(V→V)^[Ind.Intr]^[3Pl]
aghveghniiq	aghvegh(N)^@~fniigh(N→V)^[Abs.Sg]
taaqenghani	taaqe(V)^[Ctmp.Intr]^[3Sg]
enrak	enraq(PTCL)
neqekaghqameng	neqe(N)^~–kaghqagh(N→N)^[Abl_Mod.Sg]
siqluwalwaaqsaghtut	siqlugagh(N)^–lgu(N→V)^~(g)aqe(V→V)^@~fyagh(V→V)^[Ind.Intr]^[3Pl]
siqluwalwaaqsaghtukut	siqlugagh(N)^–lgu(N→V)^~(g)aqe(V→V)^@~fyagh(V→V)^[Ind.Intr]^[1Pl]
siqluwapagiisimaaq	siqlugagh(N)^–pagite(N→V)^@~:(i/u)ma(V→V)^[Ind.Intr]^[3Sg]
siqluwapagiisimaaq	siqlugagh(N)^–pagite(N→V)^@~:(i/u)ma(V→V)^[Ind.Intr]^[3Sg]
itaghnanghani	itagnagh(V)^[Ctmp.Intr]^[3Sg]
itaghnanghani	itagnagh(V)^[Ctmp.Intr]^[3Sg]
neqemeng	neqe(N)^[Abl_Mod.Sg]
siqluwalguluta	siqlugagh(N)^–lgu(N→V)^[Sbrd.Intr]^[1Pl]
siqluwat	siqlugagh(N)^[Abs.Pl]
neqekaghqaalukillu	neqe(N)^~–kaghqagh(N→N)^~:(ng)u(N→V)^[Sbrd.Trns]^[_.3Pl]^=llu
amiqenghata	amig(N)^~–ke(N→V)^~i(V→V)^~(g)aqe(V→V)^[Ind.Intr]^[3Pl]
aghnasinghaghmeng	aghnasinghagh*(N)^[Abl_Mod.Sg]
meqenghata	meqe(V)^[Ctmp.Intr]^[3Pl]
taaqenghatki	taaqe(V)^[Ctmp.Trns]^[3Pl.3Pl]
maanasqelluki	maana(DEM.PRO.Abs.Sg)^~sf:(e)sqe(CmpdVbl)^[Sbrd.Trns]^[_.3Pl]
amiiqas	amiiqagh(N)^[Abs.Pl]
aghveqinghaghmeng	aghveqinghagh(N)^[Abl_Mod.Sg]
asisighqameng	asi(AREA)^~:(u)sigh(V→N)^+kagh(N→N)^[Abl_Mod.Sg]
uyghaghmeng	uyghag(N)^[Abl_Mod.Sg]
iqugikun	iqug(N)^[Prl.3SgPoss.Pl]
kanagun	kanagun(DEM.ADV.Prl)
nengenghata	nenge(V)^[Ctmp.Intr]^[3Pl]
qafsinʼguluteng	qafsineg(WH)^~:(ng)u(N→V)^[Sbrd.Intr]^[4Pl]
uugnangillu	uugna(DEM.PRO.Abs.Sg)^[Abs.3SgPoss.Pl]^=llu
kakilaghaqiit	kaki(V)^lagh(?)^~(g)aqe(V→V)^[Ind.Trns]^[3Pl.3Pl]
kuvighluki	kuyag(N)^––igh(N→V)^[Sbrd.Trns]^[_.3Pl]
atughqaaluki	atugh(V)^@~–(g)kagh(V→N)^~:(ng)u(N→V)^[Sbrd.Trns]^[_.3Pl]
angyas	angyagh(N)^[Abs.Pl]
angyaqaqiis	angyagh(N)^~-ke(N→V)^~(g)aqe(V→V)^[Ind.Trns]^[3Pl.3Pl]
tugutluklu	tugute(N)^+llug(N→N)^[Abs.Sg]^=llu
tugutluklu	tugute(N)^+llug(N→N)^[Abs.Sg]^=llu
artifact-llu	artifact(N)^[Abs.Sg]^=llu
specimen-a	specimen(N)^[Abs.Sg]
akivagsitkaqiit	aki(N)^~f–vag(V→V)^+si(N→V)^@~:(u)tke(V→V)^~(g)aqe(V→V)^[Ind.Trns]^[3Pl.3Pl]
ullghitamun	uullghitagh(N)^[All.Sg]
neqangis	neqe(N)^[Abs.3PlPoss.Pl]
nenun	ne(N)^[All.Sg]
ayuqaqsaghaghput	ayuqe(V)^~(g)aqe(V→V)^@~fyagh(V→V)^[Ind.Trns]^[1Pl.3Sg]
share-eluku	share(V)^e(YUPIKALIZER)^[Sbrd.Trns]^[_.3Sg]
taaqneghmegteki	taaqe(V)^[Ctmp.Trns]^[4Pl.3Pl]
kiinghagu	kiig(N)^[Ctmp.Trns]^[3Sg.3Sg]
aqlaghal:ghanun	aqlagha(N)^–llegh(V→N)^[All.3SgPoss.Sg]
aqlaghallghanun	aqlagha(N)^–llegh(V→N)^[All.3SgPoss.Sg]
depends	depends(V)
on	on(PP)
uusluki	uulte(V)^[Sbrd.Trns]^[_.3Pl]
piyunemteki	piyug(V)^[Ctmp.Trns]^[1Pl.3Pl]
neghsatiu	neghsagh(N)^[Abs.Pl]^=llu
mash	mash(ADJ)
bowl-kun	bowl(N)^[Prl.Sg]
sakarameng	sakara(N)^[Abl_Mod.Sg]
angurghaallukek	?^[Sbrd.Trns]^[_.3Du]
sakara	sakara(N)^[Abs.Sg]
package-k	package(N)^[Abs.Du]
yeast-ak	yeast(N)^[Abs.Du]
tawavek	[Anaphor]^awavek(DEM.ADV.All)
palaqaniiluku	palaqanite(N)^[Sbrd.Trns]^[_.3Sg]
palaqaniiluku	palaqanite(N)^[Sbrd.Trns]^[_.3Sg]
pengughughlluki	pengugh(N)^~:(ng)ughte(N→V)^[Sbrd.Trns]^[_.3Sg]
alquutaghpaget	alquutagh(N)^+pag(V→V)^[Abs.Pl]
sakaramun	sakara(N)^[All.Sg]
parankugnun	para(N)^~sf-w:(e)nku(N→N)^[All.Pl]
sakarankugnun	sakara(N)^~sf-w:(e)nku(N→N)^[All.Pl]
sakarankugnun	sakara(N)^~sf-w:(e)nku(N→N)^[All.Pl]
angurghaalluku	?^[Sbrd.Intr]^[4Sg]
fresh	fresh(ADJ)
milk-meng	milk(N)^[Abl_Mod.Sg]
dry	dry(ADJ)
milk	milk(N)^[Abs.Sg]
yeast-allu	yeast(N)^=llu
nunmaawhaq	nunmaaggaq(PTCL)
eggbeater-elgukuvek	eggbeater(N)^e(YUPIKALIZER)^–lgu(N→V)^[Cond.Intr]^[2Sg]
electric	electric(ADJ)
beater-elgukuvek	beater(N)^e(YUPIKALIZER)^–lgu(N→V)^[Cond.Intr]^[2Sg]
angurghaannaken	?^[Opt.Fut.Trns]^[2Sg.3Sg]
beater-meng	beater(N)^[Abl_Mod.Sg]
sangighquusimeng	sangighqugh(V)^~:(u)sigh(V→N)^[Abl_Mod.Sg]
vegllumeng	vegllug(N)^[Abl_Mod.Sg]
efluugalget	eflugagh(N)^–leg(N→N)^[Abs.Pl]
amiqsaqanganeng	amigh(N)^~–ke(N→V)^@~fyagh(V→V)^@~–(g)kagh(V→N)^[Abl_Mod.3SgPoss.Sg]
sangwat	sa(N)^~:(ng)u(N→V)^[Intrg.Intr]^[3Pl]
sangaawatii	sa(N)^~:(ng)u(N→V)^[Intrg.Intr]^[3Pl]^=lli
puygaanka	puygu(V)^[Ind.Trns]^[1Sg.3Pl]
puyuqerugaqegkangi	puyuqe(V)^–ghrug(V→V)^~(g)aqe(V→V)^[Ptcp.Trns]^[3Sg.3Pl]
maanaaqluki	maana(DEM.PRO.Abs.Sg)^~(g)aqe(V→V)^[Sbrd.Trns]^[_.3Pl]
aqlaghaghraagmi	aqlagha(N)^–ghraag(V→V)^[Loc.Sg]
qateghraketun	qateghrakegtagh(N)^[Equ.Sg]
supelgaghluteng	supelghagh(V)^[Sbrd.Intr]^[4Pl]
tanughqengngwaaghaqegkangit	tanughqe(V)^~–(ghw/ngw/w)aagh(V→V)^~(g)aqe(V→V)^[Sbrd.Trns]^[_.3Pl]
nekegsaghwaaghaqelghiit	ne(N)^~–kegte(N→V)^+sagh(V→V)^~–(ghw/ngw/w)aagh(V→V)^~(g)aqe(V→V)^[Ptcp.Intr]^[3Pl]
engkangaam	enkaamngam(PTCL)
engkaangam	enkaamngam(PTCL)
aftanemteki	afta(V)^[Ctmp.Trns]^[1Pl.3Pl]
mesiighiitngwaaghluki	mesiigh(N)^~:(ng)ite(N→V)^~–(ghw/ngw/w)aagh(V→V)^[Sbrd.Trns]^[_.3Pl]
clothesline-kun	clothesline(N)^[Prl.Sg]
niightughaqhiki	niightugh(V)^~(g)aqe(V→V)^[Sbrd.Trns]^[_.3Pl]
pellughiki	pellug(V)^[Sbrd.Trns]^[_.3Pl]
maalghut	maalghug(NUM)^[Abs.Pl]
naalkakluku	naalkagh(N)^~–ke(N→V)^[Sbrd.Trns]^[_.3Sg]
zipper-elighluki	zipper(N)^e(YUPIKALIZER)^–ligh(N→V)^[Sbrd.Trns]^[_.3Pl]
ughfigi	ughhe(V)^@~fvig(V→N)^[Abs.3SgPoss.Pl]
qiipaghaghhaglimeng	qiipagh(N)^–ghhagh*(N→N)^[Abl_Mod.Sg]
nungighsigliluki	nungighte(N)^@sigh(N→V)^[Sbrd.Trns]^[_.3Pl]
nungighsigliluki	nungighte(N)^@sigh(N→V)^[Sbrd.Trns]^[_.3Pl]
angtalngakun	angtala(N)^[Prl.3SgPoss.Sg]
qulliget	qullig(V)^[Abs.Pl]
ilepghaaghes	ilepghaagheg(N)^[Abs.Pl]
ilepghaaghet	ilepghaagheg(N)^[Abs.Pl]
yearling-et	yearling(N)^[Abs.Pl]
ilepghaangllaghaqut	ilepghaagheg(N)^–ngllagh(N→V)^~(g)aqe(V→V)^[Ind.Intr]^[3Pl]
yukutaghraaggneghata	yukutate(V)^–ghraagte(V→V)^[Ctmp.Intr]^[3Pl]
petlugaqiit	pellug(V)^~(g)aqe(V→V)^[Ind.Trns]^[3Pl.3Pl]
uniilliighaghaqut	uniilliighaghte(V)^~(g)aqe(V→V)^[Ind.Intr]^[3Pl]
uniilliighallghitnun	uniilliighaghte(V)^–llegh(V→N)^[All.3PlPoss.Pl]
uniilliighaneghata	uniilliighaghte(V)^[Ctmp.Intr]^[3Pl]
kavighvaagmeng	kavighyaag(N)^[Abl_Mod.Sg]
maananayukata	maana(DEM.PRO.Abs.Sg)^[Volitive.Of.Fear]^[3Pl]
lliighqellghiit	liighqe(V)^[Ptcp.Intr]^[3Pl]
nallukekanighanka	nalluke(V)^~–kanigh(V→V)^[Ind.Trns]^[1Sg.3Pl]
tuungghughlluteng	tunge(N)^–ghte(N→V)^[Sbrd.Intr]^[4Pl]
esnelaagusighluki	esnelaaghute(V)^@sigh(N→V)^[Sbrd.Trns]^[_.3Pl]
qiipaghaghhaghmeag	qiipagh(N)^–ghhagh*(N→N)^[Abl_Mod.Sg]
temkaam	temkag(N)^[Rel.Sg]
qamanlluki	qamani(DEM.ADV.Loc)^[Sbrd.Trns]^[_.3Pl]
kamegmim	kameg(N)^[All.Sg]
atuqnaqnemteki	atuqe(V)^@~fnaqe(V→V)^[Ctmp.Trns]^[1Pl.3Pl]
unʼgavek	un'gavek(DEM.ADV.All)
mughuniighmun	mughunniigh(V)^[All.Sg]
quiyillegtat	quyillegtagh(N)^[Abs.Pl]
melqighat	melqiiqagh(N)^[Abs.Pl]
taapsaghqaafqiita	taape(V)^@~fyaghqaa(V→V)^[Opt.Neg.Pres.Trns.2Sg.3Pl]
kaamges	kameg(N)^[Abs.Pl]
kaleftaghluki	kalefkaghte(V)^[Sbrd.Trns]^[_.3Pl]
quyillegtas	quyillegtagh(N)^[Abs.Pl]
ugtinghaghmeng	ugtinghagh(N)^[Abl_Mod.Sg]
melqighaghmeng	melqiighagh(N)^[Abl_Mod.Sg]
melqighaghmeng	melqiighagh(N)^[Abl_Mod.Sg]
melqighaas	melqiighagh(N)^[Abs.Pl]
melqighaas	melqiighagh(N)^[Abs.Pl]
qaamnangi	qaamna(DEM.PRO.Abs.Sg)^[Abs.3SgPoss.Pl]
eslalighneqluki	eslalighnegh(N)^[Sbrd.Trns]^[_.3Pl]
anyaghtumi	angyagh(V)^+tugh(V→V)^[Loc.Sg]
anyaghtumi	angyagh(V)^+tugh(V→V)^[Loc.Sg]
ipigkingwaaghes	ipigkingwaagh(N)^[Abs.Pl]
melqighaawaqut	melqiighagh(N)^~:(ng)u(N→V)^~(g)aqe(V→V)^[Ind.Intr]^[3Pl]
aghhutanga	aghhutanga tamaghhaan(PTCL)
ipigkestaghhaaluki	ipigkestaaghhagh(N)^[Sbrd.Trns]^[_.3Pl]
angyaghtuusimun	angyagh(N)^+tugh(N→V)^~:(u)sigh(V→N)^[All.Sg]
akughvigas	akughvigagh*(N)^[Abs.Pl]
akughvigas	akughvigagh*(N)^[Abs.Pl]
satangighaghtellghii	sata(N)^~:(ng)igh(N→V)^~aghte(V→V)^[Ptcp.Intr]^[3Sg]
melqiighaghmeng	melqiighagh(N)^[Abl_Mod.Sg]
ivaghiyaanneghmeggni	ivagh(V)^~i(V→V)^?^[Ctmp.Intr]^[4Pl]
esnighqwataanneghmeggni	esnighqwagh(V)^?^[Ctmp.Intr]^[4Pl]
melqighas	melqiighagh(N)^[Abs.Pl]
melqighas	melqiighagh(N)^[Abs.Pl]
akughvigawaaqut	akughvigagh*(N)^~:(ng)u(N→V)^~(g)aqe(V→V)^[Ind.Intr]^[3Pl]
taaqneghatki	taaqe(V)^[Ctmp.Trns]^[3Pl.3Pl]
uywaaqaput	uygu(V)^~(g)aqe(V→V)^[Ind.Trns]^[1Pl.3Sg]
kamegkat	kameg(N)^+kagh(N→N)^[Abs.Pl]
mesiivreghaghtenghata	mesiigh(N)^–vreghagh(N→N)^+te(N→V)^[Ctmp.Intr]^[3Pl]
brush-aqaput	brush(V)^~(g)aqe(V→V)^[Ind.Trns]^[1Pl.3Pl]
soap-elighluki	soap(N)^e(YUPIKALIZER)^–ligh(N→V)^[Sbrd.Trns]^[_.3Pl]
brush-eluki	brush(V)^e(YUPIKALIZER)^[Sbrd.Trns]^[_.3Pl]
yuqutaghtesqelluki	yuqutagh(N)^+te(N→V)^~sf:(e)sqe(CmpdVbl)^[Sbrd.Trns]^[_.3Pl]
yuqutaghhneghata	yuqutagh(N)^[Ctmp.Intr]^[3Pl]
temkagkat	temkag(N)^+kagh(N→N)^[Abs.Pl]
sanaghhnemteki	sanaghte(V)^[Ctmp.Trns]^[1Pl.3Pl]
taaqnemteki	taaqe(V)^[Ctmp.Trns]^[1Pl.3Pl]
melqwighaas	melqiighagh(N)^[Abs.Pl]
melqwighaas	melqiighagh(N)^[Abs.Pl]
melqwighaas	melqiighagh(N)^[Abs.Pl]
uygaaghqas	uygaagh(N)^+kagh(N→N)^[Abs.Pl]
amiiiii	amiiragh(N)^[Abs.3SgPoss.Pl]
iiknemteki	iike(V)^[Ctmp.Trns]^[1Pl.3Pl]
iixi	iigge(N)^[Abs.3SgPoss.Pl]
tawanlluki	[Anaphor]^whaa(DEM.ADV.Loc)^[Sbrd.Trns]^[_.3Pl]
uygaaghqat	uygaagh(N)^+kagh(N→N)^[Abs.Pl]
maalghuguluta	maalghug(NUM)^~:(ng)u(N→V)^[Sbrd.Trns]^[_.3Pl]
mehghluki	mesugh(N)^[Sbrd.Trns]^[_.3Pl]
mehghluki	mesugh(N)^[Sbrd.Trns]^[_.3Pl]
kenlangangwaallghit	kenlanga(PTCL)^~–(ghw/ngw/w)aagh(V→V)^[Ptcp.Intr]^[3Pl]
ughsighaqut	ughhe(V)^@sigh(V→V)^~(g)aqe(V→V)^[Ind.Intr]^[3Pl]
suggellghelguut	segge(V)^–llegh(V→N)^–lgu(N→V)^[Ind.Intr]^[3Pl]
suggellghelguut	segge(V)^–llegh(V→N)^–lgu(N→V)^[Ind.Intr]^[3Pl]
ghefeighnaqnemteki	gheve(V)^+sigh(V→V)^@~fnaqe(V→V)^[Ctmp.Trns]^[1Pl.3Pl]
ghefeighnaqnemteki	gheve(V)^+sigh(V→V)^@~fnaqe(V→V)^[Ctmp.Trns]^[1Pl.3Pl]
ghefsineghmeng	gheve(V)^+sigh(V→V)^@~f–negh(V→N)^[Rel.4PlPoss.Sg]
kakilaghaqaput	kakilagh(V)^~(g)aqe(V→V)^[Ind.Trns]^[1Pl.3Pl]
ukimallghelgellghiit	uki(V)^@~:(i/u)ma(V→V)^–llegh(V→N)^–lgu(N→V)^[Ptcp.Intr]^[3Sg]
kakilaghluki	kakilagh(V)^[Sbrd.Trns]^[_.3Pl]
naasqwi	naasqugh(N)^[Abs.3SgPoss.Pl]
qaamkungitneng	qaamku(DEM.PRO)^[Abl_Mod.3PlPoss.Pl]
uygaaghqam	uygaagh(N)^+kagh(N→N)^[Rel.Sg]
taam	taam(PTCL)
ukimallghelgimayukata	uki(V)^@~:(i/u)ma(V→V)^–llegh(V→N)^–lgu(N→V)^[Volitive.Of.Fear]^[3Pl]
ukimallghelgimayukata	uki(V)^@~:(i/u)ma(V→V)^–llegh(V→N)^–lgu(N→V)^[Volitive.Of.Fear]^[3Pl]
kakisim	kaki(V)^~:(u)sigh(V→N)^[Rel.Sg]
qiipanghutaghhaaneng	qiipe(V)^@~f–negh(V→N)^@~:(u)ta(V→N)^–ghhagh*(N→N)^[Abl_Mod.Pl]
qiipanghutaghhaaneng	qiipe(V)^@~f–negh(V→N)^@~:(u)ta(V→N)^–ghhagh*(N→N)^[Abl_Mod.Pl]
ghuuqusighluki	ghuugh(V)^?^?^[Sbrd.Trns]^[_.3Pl]
ghuughaqaput	ghhuugh(V)^~(g)aqe(V→V)^[Ind.Trns]^[1Pl.3Pl]
kumlaanneghata	kumlate(V)^[Ctmp.Intr]^[3Pl]
uugnangi	uugna(DEM.PRO.Abs.Sg)^[Abs.3SgPoss.Pl]
uyaqughhi	uyaqugh(N)^[Abs.3SgPoss.Pl]
uyaqughhi	uyaqugh(N)^[Abs.3SgPoss.Pl]
kelaghlluki	kelag(V)^[Sbrd.Trns]^[_.3Pl]
anuqam	anuqe(V)^[Rel.Sg]
tawantaqut	[Anaphor]^whaa(DEM.ADV.Loc)^~(g)aqe(V→V)^[Ind.Intr]^[3Pl]
atughaqaghput	atugh(V)^~(g)aqe(V→V)^[Ind.Trns]^[1Pl.3Pl]
talliighiitgun	talligh(N)^–ghhagh*(N→N)^[Prl.3PlPoss.Pl]
talliighiitgun	talligh(N)^–ghhagh*(N→N)^[Prl.3PlPoss.Pl]
uvghiinemteki	uygii(V)^[Ctmp.Trns]^[1Pl.3Pl]
ghefsighluki	gheve(V)^+sigh(V→V)^[Sbrd.Trns]^[_.3Pl]
tungangakun	tunge(N)^[Prl.3SgPoss.Sg]
tungatgun	tunge(N)^[Prl.Pl]
qaamkunganeng	qaamku(DEM.PRO)^[Abl_Mod.3SgPoss.Sg]
ukimallghelgunayukata	uki(V)^@~:(i/u)ma(V→V)^–llegh(V→N)^–lgu(V→V)^[Volitive.Of.Fear]^[3Pl]
imlaangiighhaas	imlaa(N)^~fngiighhagh*(N→N)^[Abs.Pl]
aftanaqnemteki	afta(V)^@~fnaqe(V→V)^[Ctmp.Trns]^[1Pl.3Pl]
aftanaqmteki	afta(V)^@~fnaqe(V→V)^[Ctmp.Trns]^[1Pl.3Pl]
amiiraaghhii	amiiragh(N)^-ghhagh*(N→N)^[Abs.3SgPoss.Pl]
ghhuunemteki	ghhuugh(V)^[Ctmp.Trns]^[1Pl.3Pl]
naasqwakun	naasqugh(N)^[Prl.3SgPoss.Sg]
sevlughakun	seve(V)^?^[Prl.3SgPoss.Sg]
ghhatamaghmeng	ghhatagh(V)^@~:(i/u)magh*(V→QUANTQUAL)^[4Pl]
amiiras	amiiragh(N)^[Abs.Pl]
itghuiluki	itghute(V)^[Sbrd.Trns]^[_.3Pl]
sevlughhwaaneng	seve(V)^lugh^–ghhagh*(N→N)^[Abl_Mod.Pl]
qapiqeltaghluki	qapigh(V)^–ngeltagh(V→V)^[Sbrd.Trns]^[_.3Pl]
estughitneng	estug(N)^[Abl_Mod.3PlPoss.Pl]
qepughluki	qepugh(V)^[Sbrd.Trns]^[_.3Pl]
kinengllaghaqht	kinegh(V)^-ngllagh(V→V)^~(g)aqe(V→V)^[Ind.Trns]^[3Pl.3Pl]
qillaghlluki	qilleghte(V)^[Sbrd.Trns]^[_.3Pl]
ugtinghas	ugtinghagh(N)^[Abs.Pl]
kiighutesnemteki	kiighte(V)^+(te)ste(CmpdVbl)^[Ctmp.Trns]^[1Pl.3Pl]
ghevenghata	gheve(V)^[Ctmp.Intr]^[3Pl]
amiiraghhaas	amiiragh(N)^-ghhagh*(N→N)^[Abs.Pl]
ugtinghet	ugtinghagh(N)^[Abs.Pl]
uqfiillegam	uqfillegagh(N)^[Rel.Sg]
savighhwaaghluki	savigh(V)^~–(ghw/ngw/w)aagh(V→V)^[Sbrd.Trns]^[_.3Pl]
tepenghata	tepe(V)^[Ctmp.Intr]^[3Pl]
uqfiillegat	uqfillegagh(N)^[Abs.Pl]
qaayghulegenghata	qaayghu(N)^–leg(N→N)^e(EV)^[Ctmp.Intr]^[3Pl]
savighhenaamaluki	savighhe(V)^@~fnaagh(V→V)^@~:(i/u)ma(V→V)^[Sbrd.Trns]^[_.3Pl]
unlleghumaghmeng	unglleg(V)^@~:(i/u)magh*(V→QUANTQUAL)^[4Pl]
qaayghus	qaayghu(N)^[Abs.Pl]
ugtinghitkaaqaput	ugtinghagh(N)^@~:(u)tke(V→V)^~(g)aqe(V→V)^[Ind.Trns]^[1Pl.3Pl]
ugtinghitkaaqaput	ugtinghagh(N)^@~:(u)tke(V→V)^~(g)aqe(V→V)^[Ind.Trns]^[1Pl.3Pl]
ughtinghitet	ugtinghagh(N)^@~:(u)te(V→N)^[Abs.Pl]
kuuvenemteki	kuuve(V)^[Ctmp.Trns]^[1Pl.3Pl]
kavighqwaaghaqut	kavigh(N)^––igh(N→V)^~-(ghw/ngw/w)aagh(V→V)^~(g)aqe(V→V)^[Ind.Intr]^[3Pl]
puufsighluki	puuve(V)^+sigh(V→V)^[Sbrd.Trns]^[_.3Pl]
itghuugunneghsighaqaputi	itghuugute(V)^@~f–negh(V→N)^+sigh(V→V)^~(g)aqe(V→V)^[Ind.Trns]^[1Pl.3Pl]
elngaata	elngaatall(PTCL)
ugtinghitet	ugtinghagh(N)^@~:(u)te(V→N)^[Abs.Pl]
kepellghaanun	kepellegh(N)^[All.3SgPoss.Sg]
atughqaalluki	atugh(N)^+kagh(N→N)^~:(ng)u(N→V)^[Sbrd.Trns]^[_.3Pl]
kelaggnemteki	kelag(V)^[Ctmp.Trns]^[1Pl.3Pl]
kehigi	kelug(N)^[Abs.3SgPoss.Pl]
aghighhaqapus	aghi(V)^?^~(g)aqe(V→V)^[Ind.Trns]^[1Pl.3Pl]
pellumghaghaqaput	pellug(V)^?^~(g)aqe(V→V)^[Ind.Trns]^[1Pl.3Pl]
atughqaghqaqaput	atugh(N)^+kagh(N→N)^~-ke(N→V)^~(g)aqe(V→V)^[Ind.Trns]^[1Pl.3Pl]
sukilpaghhaas	sukilpagh*(N)^-ghhagh*(N→N)^[Abs.Pl]
atkugkaaghhneghmegteld	atkugkagh(N)^–ghte(N→V)^[Ctmp.Trns]^[4Pl.3Pl]
atkugkaaghhneghmegteld	atkugkagh(N)^–ghte(N→V)^[Ctmp.Trns]^[4Pl.3Pl]
qugiinii	quginagh(N)^[Abs.3SgPoss.Pl]
qavngarugllak	qavngaq(WH)^–ghrug(V→V)^–ghllag(V→N)^[Abs.Sg]
qavngarugllak	qavngaq(WH)^–ghrug(V→V)^–ghllag(V→N)^[Abs.Sg]
ughhustaqiit	ughhe(V)^~:(ng)u(V→V)^+(te)ste(CmpdVbl)^~(g)aqe(V→V)^[Ind.Trns]^[3Pl.3Pl]
mesiighneghitngwaanghata	mesiigh(V)^@–nghite(V→V)^~–(ghw/ngw/w)aagh(V→V)^[Ctmp.Intr]^[3Pl]
mesiighneghitngwaanghata	mesiigh(V)^@–nghite(V→V)^~–(ghw/ngw/w)aagh(V→V)^[Ctmp.Intr]^[3Pl]
sategtaqnayagaput	sategte(V)^~(g)aqe(V→V)^@~fnayagh(V→V)^[Ind.Trns]^[1P.3Pl]
amighqwaaghii	amighqwaagh(N)^–ghhagh*(N→N)^[Abs.3SgPoss.Pl]
nuvmghluki	nuvugh(V)^[Sbrd.Trns]^[_.3Pl]
tukruugfagilata	tukrug(V)^~:(ng)ughte(N→V)^[Prec.Intr]^[3Pl]
seggughaqiit	segge(V)^?^~(g)aqe(V→V)^[Ind.Trns]^[1Pl.3Pl]
qafsinwaaqat	qafsineg(WH)^~:(ng)u(N→V)^~(g)aqe(V→V)^[Intrg.Intr]^[3Pl]
sukilpat	sukilpagh*(N)^[Abs.Pl]
melqwaneng	melqugh(N)^[Abl_Mod.3SgPoss.Sg]
nagnaaqusighluki	nagnaaqute(N)^@sigh(N→V)^[Sbrd.Trns]^[_.3Pl]
puvisighaqiitlu	puvite(N)^@sigh(N→V)^~(g)aqe(V→V)^[Ind.Trns]^[1Pl.3Pl]^=llu
taghneqegtaa	tagnegh(V)^@–nqegtagh(V→N)^[Abs.3SgPoss.Sg]
uqemelengestaaghhaat	uqe(N)^–mleghagh(N→N)^–ngestagh(N→N)^–ghhagh*(N→N)^[Abs.Pl]
uqemelengestaaghhaat	uqe(N)^–mleghagh(N→N)^–ngestagh(N→N)^–ghhagh*(N→N)^[Abs.Pl]
atkugkaaghhneghmegteki 	atkug(N)^+kagh(N→N)^[Ctmp.Trns]^[4Pl.3Pl]
ighneghlluges	ighneghllug(N)^[Abs.Pl]
maklaguugut	maklagu(N)^~:(ng)u(N→V)^[Ind.Intr]^[3Pl]
natangi	natu(WH)^[Abs.3SgPoss.Pl]
natangi	natu(WH)^[Abs.3SgPoss.Pl]
taanʼgani	[Anaphor]^un'gani(DEM.ADV.Loc)
qaanmangi	qaamna(DEM.PRO.Abs.Sg)^[Abs.3SgPoss.Pl]
qaanmangi	qaamna(DEM.PRO.Abs.Sg)^[Abs.3SgPoss.Pl]
kdigaghaqiit	keligagh(V)^~(g)aqe(V→V)^[Ind.Trns]^[3Pl.3Pl]
narangunaan	naranghite(V)^[Sbrd.Trns]^[_.3Sg]
enraghngam	enragh(PTCL)^=ngam
aghsughhnaqenghinneghmegteki	aghsugh(V)^@~fnaqe(V→V)^@–nghite(V→V)^[Ctmp.Trns]^[4Pl.3Pl]
aghsughhnaqenghinneghmegteki	aghsugh(V)^@~fnaqe(V→V)^@–nghite(V→V)^[Ctmp.Trns]^[4Pl.3Pl]
kiinghwaanghata	kinegh(V)^~–(ghw/ngw/w)aagh(V→V)^[Ctmp.Intr]^[3Pl]
seggughluki	segge(V)^@qugh(V→V)^[Sbrd.Trns]^[_.3Pl]
aghsughtas	aghsughaghsugh(V)^@~:(u)te(V→N)^[Abs.Pl]
aghsughtas	aghsughaghsugh(V)^@~:(u)te(V→N)^[Abs.Pl]
iiggemeggneng	iigge(N)^[Abl_Mod.4PlPoss.Sg]
atighaqsaghet	atigh(V)^~(g)aqe(V→V)^+sagh(V→V)^[Abs.Pl]
uusiuki	uulte(V)^[Sbrd.Trns]^[_.3Pl]
uusiuki	uulte(V)^[Sbrd.Trns]^[_.3Pl]
kanaghlluget	kanagh(V)^+llug(V→V)^[Abs.Pl]
ighncghllupiget	ighneghllug(N)^–pig(N→N)^[Rel.Pl]
igfineghlluget	ighneghllug(N)^[Abs.Pl]
aghsughtellghelnguut	aghsugh(V)^+te(POS→ACTIVE)^–llegh(V→N)^?^[Ptcp.Intr]^[3Pl]
aghsughhnaqneghmegteki	aghsugh(V)^@~fnaqe(V→V)^[Ctmp.Trns]^[4Pl.3Pl]
uullnaqneghmegteki	uulte(V)^@~fnaqe(V→V)^[Ctmp.Trns]^[4Pl.3Pl]
pilagnayukamegteki	pilag(V)^[Volitive.Of.Fear]^[4Pl.3Pl]
nusugiuki	nusug(V)^[Sbrd.Trns]^[_.3Pl]
sagneghpagkun	sagnegh(N)^+pag(V→V)^[Prl.Sg]
maanaaqiit	maana(DEM.PRO.Abs.Sg)^~(g)aqe(V→V)^[Ind.Trns]^[3Pl.3Pl]
iglagaaneng	iglag(N)^[Abl_Mod.Pl]
qapighhaqiit	qapigh(V)^~(g)aqe(V→V)^[Ind.Trns]^[3Pl.3Pl]
nekegsaataqut	nekeg(POS)^@~fyagh(V→V)^@~:(u)te(V→V)^~(g)aqe(V→V)^[Ind.Intr]^[3Pl]
aqeftaghaghqaaluki	aqeftaghaagh(N)^+kagh(N→N)^~:(ng)u(N→V)^[Sbrd.Trns]^[_.3Pl]
siighnas	siighnagh(N)^[Abs.Pl]
aqeftaghaghamun	aqeftaghaagh(N)^?^[All.Sg]
unatapsugmun	unatagh(V)^–msug(V→V)^[All.Sg]
unatapsugmun	unatagh(V)^–msug(V→V)^[All.Sg]
aghnasallghiinaam	aghnasaleg(N)^–ghhagh*(N→N)^~:(ng)inagh*(N→N)^[Rel.Sg]
aghnasallghiinaam	aghnasaleg(N)^–ghhagh*(N→N)^~:(ng)inagh*(N→N)^[Rel.Sg]
kiinghaqiis	kinegh(V)^~(g)aqe(V→V)^[Ind.Trns]^[3Pl.3Pl]
akuwaaq	akugaaq(PTCL)
kinkungutangi	kinku(WH)^~:(ng)u(N→V)^@~:(u)te(V→N)^[Abs.3SgPoss.Pl]
ayumirugllaak	ayumigh*(N)^–ghrug(N→N)^–ghllag(N→N)^[Abs.Sg]
Alaska	Alaska(N)^[Abs.Sg]
Alaska-mi	Alaska(N)^[Loc.Sg]
neqekluteng	neqe(N)^~–ke(N→V)^[Sbrd.Intr]^[4Pl]
scientist-tet	scientist(N)^[Abs.Pl]
Onion	onion(N)^[Abs.Sg]
Portage-enʼnguq	portage(N)^?^=nguq
Tangle	Tangle(N)^[Abs.Sg]
Lake	lake(N)^[Abs.Sg]
Healy	Healy(N)^[Abs.Sg]
maanlenguq	maanlenguq(PTCL)
kiwanlenguq	kiwanlenguq(PTCL)
Geist-am	Geist(N)^[Rel.Sg]
archeologist-em	archeologist(N)^[Rel.Sg]
University-nganun	university(N)^[All.3SgPoss.Sg]
Alaska-m	Alaska(N)^[Rel.Sg]
iigfikegkaa	iigge(V)^@~fvike(V→V)^@~–(g)kagh(V→N)^[Abs.3SgPoss.Sg]
entagun	entaqun(PTCL)
years-ngughtuq	years(N)^~:(ng)ughte(N→V)^[Ind.Intr]^[3Sg]
whangamnillu	whangamni(PRO.Loc.1Sg)^=llu
taam	taam(PTCL)
angtalnga	angtala(N)
feet	foot(N)^[Abs.Pl]
tagtalnga	tagtala(N)^[Abs.3SgPoss.Sg]
iqetulnga	iqetutale(N)
aghyuqaghtulnga	aghyugh(V)^@~–(g)kagh(V→N)^?^[Abs.3SgPoss.Sg]
maatemeng	maaten(PTCL)^[Abl_Mod.Sg]
qafsinʼguut	qafsineg(WH)^~:(ng)u(N→V)^[Ind.Intr]^[3Pl]
naalkutaaghenʼnguq	naalke(V)^@~:(u)te(V→V)^+aagh(V→N)^[Abs.2SgPoss.Sg]^=nguq
qaspiqullghiineng	qaspighte(V)^–qu(V→V)^@–lghii(V→N)^[Abl_Mod.Pl]
sanquutaaghit	sanqute(N)^?^[Abs.3PlPoss.Pl]
Old	old(ADJ)
Bering	Bering(N)
Sea-ghmiinun	Sea(N)^?^[All.4SgPoss.Sg]
siqluwaghyagmiit	siqlugagh(N)^+yage(N→N)^~fmii(N→N)^[Abs.Pl]
taakwavek	[Anaphor]^ukavek(DEM.ADV.All)
years-ngut	years(N)^~:(ng)u(N→V)^[Ind.Intr]^[3Pl]
years-ngut	years(N)^~:(ng)u(N→V)^[Ind.Intr]^[3Pl]
taakwani	[Anaphor]^ukani(DEM.ADV.Loc)
ayuqekanightut	ayuqe(V)^~–kanigh(V→V)^@~:(u)te(V→V)^[Ind.Intr]^[3Pl]
years-nguut	years(N)^~:(ng)u(N→V)^[Ind.Intr]^[3Pl]
ingavaqaantat	ingavek(DEM.ADV.All)^?
unʼganlenguut	un'ganlenguq(PTCL)^~:(ng)u(N→V)^[Ind.Intr]^[3Pl]
natangani	nate(WH)^[Loc.3SgPoss.Sg]
Anangtinkut	Anangti(N)^~sf-w:(e)nku(N→N)^[Abs.Pl]
Taangyatentkut	Taangyan(N)^~sf-w:(e)nku(N→N)^[Abs.Pl]
liigikeghraagaghput	liigike(V)^–ghraag(V→V)^?^[Abs.1PlPoss.Sg]
Sea	sea(N)^[Abs.Sg]
two-mi	two(NUM)^[Loc.Sg]
whangamni	whangamni(PRO.Loc.1Sg)
qaayvantaqluteng	qaye(N)^?^~(g)aqe(V→V)^[Sbrd.Intr]^[4Pl]
Punguum	Punug(N)^[Rel.Sg]
culture-nga	culture(N)^[Abs.3SgPoss.Sg]
mingiilluni	mingite(V)^[Sbrd.Intr]^[4Sg]
Dr.	Dr.(N)^[Abs.Sg]
Bandim	Bandim(N)^[Abs.Sg]
Ketngipalam	Ketngipalag(N)^[Rel.Sg]
pengwaakraganilnguut	pengwaagh(N)^–krag(N→N)^?^[Ptcp.Intr]^[3Pl]
tazikna	[Anaphor]^iigna(DEM.PRO.Abs.Sg)
ilggnemta	iigge(V)^[Ctmp.Intr]^[1Pl]
culturemeng	culture(N)^[Abl_Mod.Sg]
sivulightalleghpiigaaguq	sivuligh*(N)^?^–lleghpigagh(V→N)^[Ind.Intr]^[3Sg]
maalghut	maalghug(NUM)^[Abs.Pl]
qamavneghtuqat	qamavek(DEM.ADV.All)^@~f–negh(V→N)^–tuqagh(N→N)^[Abs.Pl]
years-neng	years(N)^[Abl_Mod.Pl]
ingavantuq	ingavek(DEM.ADV.All)^?^[Ind.Intr]^[3Sg]
uliimaaghita	ulimaagh(N)^[Rel.3PlPoss.Pl]
samavneghtuqat	samavek(DEM.ADV.All)^@~f–negh(V→N)^–tuqagh(N→N)^[Abs.Pl]
qaayvanlenguut	qaayvanlenguq(PTCL)^~:(ng)u(N→V)^[Ind.Intr]^[3Pl]
one-nguuk	one(NUM)^~:(ng)u(N→V)^[Ind.Intr]^[3Du]
years	years(N)^[Abs.Sg]
Sea-m	sea(N)^[Rel.Sg]
ulimayiitkanit	ulima(V)^@~f–yiite(V→V)^~–kanigh(V→V)^[Abs.Pl]
tukfiighinaaquteghliaquut	tukfigh(V)^~i(V→V)^@~fnaqute(V→V)^–ghllagu(V→V)^[Ind.Intr]^[3Pl]
tukfiighinaaquteghliaquut	tukfigh(V)^~i(V→V)^@~fnaqute(V→V)^–ghllagu(V→V)^[Ind.Intr]^[3Pl]
allaaghlluwhaghmeng	allaaghlluggagh*(N)^[Abl_Mod.Sg]
tawatekaniq	tawate(V)^~–kanigh(V→V)^[Abs.Sg]
ullimallghi	ulima(V)^–llegh(V→N)^[Abs.3SgPoss.Pl]
ullmallghi	ulima(V)^–llegh(V→N)^[Abs.3SgPoss.Pl]
Egypt-eghmiit	Egypt(N)^?^~fmii(N→N)^[Abs.Pl]
ulmaaghistun	ulimaagh(N)^[Equ.Pl]
ulmaaghistun	ulimaagh(N)^[Equ.Pl]
Indian-eghmiistun	Indian(N)^?^~fmii(N→N)^[Equ.Pl]
tukfiighinaaquteghllaquut	tukfigh(V)^~:(ng)inagh(V→V)^@~:(u)te(V→V)^–ghllag(V→V)^~(g)aqe(V→V)^[Ind.Intr]^[3Pl]
neqengyupaarugllak	neqengyu(V)^–perug(N→N)^–ghllag(N→N)^[Abs.Sg]
neqengyupaarugllak	neqengyu(V)^–perug(N→N)^–ghllag(N→N)^[Abs.Sg]
piyaaneng	piyaa(V)^[Abl_Mod.Pl]
neghsaghsighaghllagluni	neghsagh(N)^?^–ghllag(V→V)^[Sbrd.Intr]^[4Sg]
upuupeng	upupeng(PTCL)
ugwinganguq	ugi(N)^[Abs.3SgPoss.Sg]^=nguq
ugwingan	ugi(N)^[Rel.3SgPoss.Sg]
nakenʼnguq	naken(WH)^=nguq
taakwegken	[Anaphor]^ukegken(DEM.ADV.Abl_Mod)
iteghaatuk	itegh(V)^?^[Ind.Intr]^[3Pl]
tawavek	[Anaphor]^awavek(DEM.ADV.All)
iteghaallutek	itegh(V)^?^[Sbrd.Intr]^[4Du]
ugwika	ugi(N)^[Abs.1SgPoss.Sg]
neqengyiighullii	neqengyu(V)^~:(ng)i:ghute(N→V)^?^=lli
ugwini	ugini(N)^[Abs.Sg]
pemakanga	pi(V)^@~:(i/u)ma(V→V)^[Ptcp.Trns]^[3Sg.3Sg]
aghhutanga	aghhutanga tamaghhaan(PTCL)
aghulaqenghani	aghulaqe(V)^[Ctmp.Intr]^[3Sg]
aghulaqaqlluni	aghulaqe(V)^~(g)aqe(V→V)^[Sbrd.Intr]^[4Sg]
taam	taam(PTCL)
ellnginaghhaghpek	ellnginagh*(QUANTQUAL)^–ghhagh*(N→N)^[2Sg]
pellaghyugigasiin	pellagh(EMO)^@~fyug(EMO→V)^@~:(ng)igate(V→V)^[Intrg.Intr.2Sg]
ighsakestamikunʼnguq	ighsake(V)^–kestagh(V→V)^[Prl.4SgPoss.Sg]^=nguq
iilqwa	?
taakwavek	[Anaphor]^ukavek(DEM.ADV.All)
iqlighmi	iqligh(V)^[Loc.Sg]
unillukuu	unite(V)^[Sbrd.Trns]^[_.3Sg]
taklaghlluni	taklagh(POS)^[Sbrd.Intr]^[4Sg]
aghnaqelqusigpenang	aghnaqe(V)^–lqusigh(N→PTCL)^@–nghite(V→V)^[Sbrd.Intr]^[2Sg]
iqlighpek	iqligh(V)^[Rel.2SgPoss.Sg]
tuquuluni	tuqu(V)^[Sbrd.Intr]^[4Sg]
aneghneghsughyaqminigu	aneghneghte(V)^?^[PtcpObl.Trns]^[4Sg.3Sg]
ii	ii(PTCL)
inagmikluku	inagmig(V)^[Sbrd.Trns]^[_.3Sg]
naagu	na(WH)^[Intrg.Trns]^[2Pl.3Sg]
ukaa	uka(DEM.ADV)
esghalqugpenaanʼnguq	esghalluug(V)^@–nghite(V→V)^[Sbrd.Trns]^[_.3Sg]^=nguq
uumlleqa	?
tawatenʼnguq	tawaten(PTCL)^=nguq
uulghumalghii	ullegh(V)^@~:(i/u)ma(V→V)^[Ptcp.Intr]^[3Sg]
aliinghakuun	aliinegh(N)^[Prl.3SgPoss.Sg]
uksuum	uksugh(V)^[Rel.Sg]
uaten	naten(WH)
eslegkakaa	eslege(V)^@~–(g)kaqe(V→V)^[Ind.Trns]^[3Sg.3Sg]
mataghlluku	matagh*(POS)^[Sbrd.Trns]^[_.3Sg]
kelutangani	kelute(AREA)^[Loc.3SgPoss.Sg]
amestaaghhaaguq	?^[Ind.Intr]^[3Sg]
ughhu-ghhuu	ughhu-ghhuu(XCLM)
tawantuq	[Anaphor]^whaa(DEM.ADV.Loc)^[Ind.Intr]^[3Sg]
tawantuq	[Anaphor]^whaa(DEM.ADV.Loc)^[Ind.Intr]^[3Sg]
nalighhiiniita	naligh(WH)^~:(ng)inagh*(N→N)^[Rel.3PlPoss.Sg]
nalighhiiniita	naligh(WH)^~:(ng)inagh*(N→N)^[Rel.3PlPoss.Sg]
nalighhiiniita	naligh(WH)^~:(ng)inagh*(N→N)^[Rel.3PlPoss.Sg]
maateqwaaqun	maateqwaakun(PTCL)
atkugwa	atkug(N)^[Abs.3SgPoss.Sg]
nenglaghyugllaghngaaghmi	nenglagh(V)^@~fyug(V→V)^–ghllag(V→V)^[Conc.Intr]^[4Sg]
ggaatfaka	ggate(N)^~f–vag(V→V)^[Abs.1SgPoss.Sg]
sangantuq-aa	sangan(WH)^[Ind.Intr]^[3Sg]^?
atkuwhaqa	atkug(N)^~–(ghw/ngw/w)aagh(N→N)^[Abs.1SgPoss.Sg]
keluwhii	?
avleghruuggnaluki	avlegh(POS)^–ghrug(V→V)^[Sbrd.Trns]^[_.3Pl]
avleghruuggnaluki	avlegh(POS)^–ghrug(V→V)^[Sbrd.Trns]^[_.3Pl]
ighuvagegka	ighu(N)^~f–vag(V→V)^[Abs.1SgPoss.Du]
qulliggaagka	qulligeg(N)^[Abs.1SgPoss.Du]
iqlighmi	iqligh(V)^[Loc.Sg]
allaaghiinaghmeng	allaghhiinagh(PTCL)^[Abl_Mod.Sg]
allaaghiinaghmeng	allaghhiinagh(PTCL)^[Abl_Mod.Sg]
ukagun-aa	ukagun(DEM.ADV.Prl)^?
pirughtiisaghqameng	pirughte(V)^~i(V→V)^@~fyaghqagh(V→N)^[Abl_Mod.Sg]
pirughtiisaghqameng	pirughte(V)^~i(V→V)^@~fyaghqagh(V→N)^[Abl_Mod.Sg]
kaviighham	kaviigh(N)^[Rel.Sg]
pigpengang	pi(V)^@–nghite(V→V)^[Sbrd.Intr]^[2Sg]
qayngunwhaa	qayngun(PTCL)
qayngunwhaa	whaa(DEM.ADV)
tunusat	tuunusagh(N)^[Abs.Pl]
sikughaaghenkunun	sikughaagh(N)^~sf-w:(e)nku(N→N)^[All.Pl]
kaasalghlimi	kaate(V)^[PtcpObl.Intr]^[4Sg]
natenllaam	naten(WH)^?
aqumlunl	aqume(V)^[Sbrd.Intr]^[4Sg]
nulglighllagluni	nulgiigh(V)^–ghllag(V→V)^[Sbrd.Intr]^[4Sg]
ilangl	ila(N)^[Abs.3SgPoss.Pl]
whangamneng	whangamneng(PRO.Abl_Mod.1Sg)
meteghllugwem	meteghllug(N)^[Rel.Sg]
aa-ha-ha-haa	aa-ha-ha-haa(XCLM)
akugllaka	atkug(V)^–ghllag(V→N)^[Abs.1SgPoss.Sg]
uguminaqruwhaghmeng	uguminqe(V)^–ghrug(V→V)^~–(ghw/ngw/w)aagh(V→V)^[Abl_Mod.Sg]
uguminaqruwhaghmeng	uguminqe(V)^–ghrug(V→V)^~–(ghw/ngw/w)aagh(V→V)^[Abl_Mod.Sg]
meteghlugwem	meteghllug(N)^[Rel.Sg]
meteghlugwem	meteghllug(N)^[Rel.Sg]
isekinam	isekinagh(V)^[Rel.Sg]
qungyaghagneng	qungyagh(V)^[Abl_Mod.3SgPoss.Sg]
nalugwigalnguq	nalug(V)^@~:(ng)igate(V→V)^[Ptcp.Intr]^[3Sg]
ilepghaaqiinaghluni	ilepghaagheg(N)^~:(ng)inagh*(N→N)^[Sbrd.Intr]^[4Sg]
ilepghaaqiinaghluni	ilepghaagheg(N)^~:(ng)inagh*(N→N)^[Sbrd.Intr]^[4Sg]
kii-ii	kii(PTCL)
uuk-aa	uuk-aa(XCLM)
alingesugninnaqepiglluku	alinge(V)^+sugnite(V→V)^@~fnaqe(V→V)^–pig(N→N)^[Sbrd.Trns]^[_.3Sg]
mataghlluki	matagh*(POS)^[Sbrd.Trns]^[_.3Pl]
qulligegka	qulligeg(N)^[Abs.1SgPoss.Du]
